STATE/UT,YEAR,DEMOGRAPHIC PARTICULARS,Male Convicts,Female Convicts,Total Convicts,Male Under trial,Female Under trial,Total Under trial,Male Detenues,Female Detenues,Total Detenues,Male Others,Female Others,Total Others,Total Male,Total Female,Grand Total
ANDHRA PRADESH,2001,Educational Standard,4119,102,4221,8360,482,8842,4,1,5,22,0,22,12505,585,13090
ANDHRA PRADESH,2001,Educational Standard - Illiterate,1441,82,1523,3794,361,4155,1,1,2,8,0,8,5244,444,5688
ANDHRA PRADESH,2001,Educational Standard - Below Class X,1729,20,1749,2833,89,2922,0,0,0,10,0,10,4572,109,4681
ANDHRA PRADESH,2001,Educational Standard - Class X and above but below graduate,532,0,532,1260,26,1286,2,0,2,2,0,2,1796,26,1822
ANDHRA PRADESH,2001,Educational Standard - Graduate,299,0,299,272,3,275,0,0,0,2,0,2,573,3,576
ANDHRA PRADESH,2001,Educational Standard - Post-Graduate,72,0,72,37,1,38,0,0,0,0,0,0,109,1,110
ANDHRA PRADESH,2001,Educational Standard - Holding technical degree/diploma etc,46,0,46,164,2,166,1,0,1,0,0,0,211,2,213
ANDHRA PRADESH,2002,Educational Standard,4721,151,4872,7992,557,8549,2,0,2,0,0,0,12715,708,13423
ANDHRA PRADESH,2002,Educational Standard - Illiterate,1931,93,2024,3649,464,4113,0,0,0,0,0,0,5580,557,6137
ANDHRA PRADESH,2002,Educational Standard - Below Class X,1879,54,1933,2882,74,2956,0,0,0,0,0,0,4761,128,4889
ANDHRA PRADESH,2002,Educational Standard - Class X and above but below graduate,647,4,651,1150,16,1166,2,0,2,0,0,0,1799,20,1819
ANDHRA PRADESH,2002,Educational Standard - Graduate,189,0,189,181,2,183,0,0,0,0,0,0,370,2,372
ANDHRA PRADESH,2002,Educational Standard - Post-Graduate,21,0,21,35,0,35,0,0,0,0,0,0,56,0,56
ANDHRA PRADESH,2002,Educational Standard - Holding technical degree/diploma etc,54,0,54,95,1,96,0,0,0,0,0,0,149,1,150
ANDHRA PRADESH,2003,Educational Standard,4975,172,5147,8378,541,8919,18,0,18,0,0,0,13371,713,14084
ANDHRA PRADESH,2003,Educational Standard - Illiterate,1653,91,1744,3242,365,3607,7,0,7,0,0,0,4902,456,5358
ANDHRA PRADESH,2003,Educational Standard - Below Class X,2317,69,2386,3507,133,3640,6,0,6,0,0,0,5830,202,6032
ANDHRA PRADESH,2003,Educational Standard - Class X and above but below graduate,736,10,746,1178,37,1215,3,0,3,0,0,0,1917,47,1964
ANDHRA PRADESH,2003,Educational Standard - Graduate,210,1,211,303,6,309,2,0,2,0,0,0,515,7,522
ANDHRA PRADESH,2003,Educational Standard - Post-Graduate,32,1,33,66,0,66,0,0,0,0,0,0,98,1,99
ANDHRA PRADESH,2003,Educational Standard - Holding technical degree/diploma etc,27,0,27,82,0,82,0,0,0,0,0,0,109,0,109
ANDHRA PRADESH,2004,Educational Standard,4568,197,4765,8499,579,9078,29,9,38,0,0,0,13096,785,13881
ANDHRA PRADESH,2004,Educational Standard - Illiterate,1616,143,1759,3546,404,3950,10,9,19,0,0,0,5172,556,5728
ANDHRA PRADESH,2004,Educational Standard - Below Class X,2084,50,2134,3463,145,3608,9,0,9,0,0,0,5556,195,5751
ANDHRA PRADESH,2004,Educational Standard - Class X and above but below graduate,645,1,646,1089,23,1112,8,0,8,0,0,0,1742,24,1766
ANDHRA PRADESH,2004,Educational Standard - Graduate,162,3,165,301,7,308,2,0,2,0,0,0,465,10,475
ANDHRA PRADESH,2004,Educational Standard - Post-Graduate,31,0,31,46,0,46,0,0,0,0,0,0,77,0,77
ANDHRA PRADESH,2004,Educational Standard - Holding technical degree/diploma etc,30,0,30,54,0,54,0,0,0,0,0,0,84,0,84
ANDHRA PRADESH,2005,Educational Standard,4813,198,5011,8906,686,9592,10,0,10,0,0,0,13729,884,14613
ANDHRA PRADESH,2005,Educational Standard - Illiterate,1592,126,1718,3320,421,3741,6,0,6,0,0,0,4918,547,5465
ANDHRA PRADESH,2005,Educational Standard - Below Class X,2271,69,2340,4056,233,4289,2,0,2,0,0,0,6329,302,6631
ANDHRA PRADESH,2005,Educational Standard - Class X and above but below graduate,701,1,702,1112,26,1138,1,0,1,0,0,0,1814,27,1841
ANDHRA PRADESH,2005,Educational Standard - Graduate,181,2,183,322,6,328,1,0,1,0,0,0,504,8,512
ANDHRA PRADESH,2005,Educational Standard - Post-Graduate,35,0,35,38,0,38,0,0,0,0,0,0,73,0,73
ANDHRA PRADESH,2005,Educational Standard - Holding technical degree/diploma etc,33,0,33,58,0,58,0,0,0,0,0,0,91,0,91
ANDHRA PRADESH,2006,Educational Standard,5080,207,5287,9445,637,10082,17,1,18,34,0,34,14576,845,15421
ANDHRA PRADESH,2006,Educational Standard - Illiterate,1700,132,1832,3908,482,4390,1,0,1,5,0,5,5614,614,6228
ANDHRA PRADESH,2006,Educational Standard - Below Class X,2202,61,2263,3653,132,3785,16,1,17,23,0,23,5894,194,6088
ANDHRA PRADESH,2006,Educational Standard - Class X and above but below graduate,818,6,824,1429,21,1450,0,0,0,3,0,3,2250,27,2277
ANDHRA PRADESH,2006,Educational Standard - Graduate,167,7,174,304,2,306,0,0,0,1,0,1,472,9,481
ANDHRA PRADESH,2006,Educational Standard - Post-Graduate,52,0,52,50,0,50,0,0,0,2,0,2,104,0,104
ANDHRA PRADESH,2006,Educational Standard - Holding technical degree/diploma etc,141,1,142,101,0,101,0,0,0,0,0,0,242,1,243
ANDHRA PRADESH,2007,Educational Standard,5327,232,5559,8810,635,9445,21,0,21,20,0,20,14178,867,15045
ANDHRA PRADESH,2007,Educational Standard - Illiterate,1420,155,1575,3386,466,3852,5,0,5,3,0,3,4814,621,5435
ANDHRA PRADESH,2007,Educational Standard - Below Class X,2478,52,2530,4034,132,4166,11,0,11,11,0,11,6534,184,6718
ANDHRA PRADESH,2007,Educational Standard - Class X and above but below graduate,1019,18,1037,957,23,980,5,0,5,6,0,6,1987,41,2028
ANDHRA PRADESH,2007,Educational Standard - Graduate,189,6,195,221,8,229,0,0,0,0,0,0,410,14,424
ANDHRA PRADESH,2007,Educational Standard - Post-Graduate,55,0,55,58,0,58,0,0,0,0,0,0,113,0,113
ANDHRA PRADESH,2007,Educational Standard - Holding technical degree/diploma etc,166,1,167,154,6,160,0,0,0,0,0,0,320,7,327
ANDHRA PRADESH,2008,Educational Standard,5155,223,5378,8018,651,8669,21,0,21,12,0,12,13206,874,14080
ANDHRA PRADESH,2008,Educational Standard - Illiterate,1370,144,1514,2820,458,3278,5,0,5,4,0,4,4199,602,4801
ANDHRA PRADESH,2008,Educational Standard - Below Class X,2489,55,2544,3640,150,3790,5,0,5,5,0,5,6139,205,6344
ANDHRA PRADESH,2008,Educational Standard - Class X and above but below graduate,832,14,846,1190,38,1228,9,0,9,3,0,3,2034,52,2086
ANDHRA PRADESH,2008,Educational Standard - Graduate,323,8,331,238,4,242,2,0,2,0,0,0,563,12,575
ANDHRA PRADESH,2008,Educational Standard - Post-Graduate,100,1,101,42,0,42,0,0,0,0,0,0,142,1,143
ANDHRA PRADESH,2008,Educational Standard - Holding technical degree/diploma etc,41,1,42,88,1,89,0,0,0,0,0,0,129,2,131
ANDHRA PRADESH,2009,Educational Standard,4339,197,4536,7640,577,8217,38,2,40,15,0,15,12032,776,12808
ANDHRA PRADESH,2009,Educational Standard - Illiterate,1079,108,1187,2825,378,3203,2,1,3,4,0,4,3910,487,4397
ANDHRA PRADESH,2009,Educational Standard - Below Class X,2073,58,2131,2926,143,3069,29,1,30,11,0,11,5039,202,5241
ANDHRA PRADESH,2009,Educational Standard - Class X and above but below graduate,799,16,815,1218,45,1263,7,0,7,0,0,0,2024,61,2085
ANDHRA PRADESH,2009,Educational Standard - Graduate,286,13,299,447,6,453,0,0,0,0,0,0,733,19,752
ANDHRA PRADESH,2009,Educational Standard - Post-Graduate,76,2,78,110,3,113,0,0,0,0,0,0,186,5,191
ANDHRA PRADESH,2009,Educational Standard - Holding technical degree/diploma etc,26,0,26,114,2,116,0,0,0,0,0,0,140,2,142
ANDHRA PRADESH,2010,Educational Standard,4567,231,4798,7103,546,7649,28,2,30,13,0,13,11711,779,12490
ANDHRA PRADESH,2010,Educational Standard - Illiterate,1638,127,1765,2693,356,3049,5,2,7,7,0,7,4343,485,4828
ANDHRA PRADESH,2010,Educational Standard - Below Class X,1546,77,1623,2923,151,3074,21,0,21,5,0,5,4495,228,4723
ANDHRA PRADESH,2010,Educational Standard - Class X and above but below graduate,786,22,808,1030,28,1058,0,0,0,0,0,0,1816,50,1866
ANDHRA PRADESH,2010,Educational Standard - Graduate,387,4,391,261,8,269,0,0,0,0,0,0,648,12,660
ANDHRA PRADESH,2010,Educational Standard - Post-Graduate,100,1,101,52,2,54,0,0,0,0,0,0,152,3,155
ANDHRA PRADESH,2010,Educational Standard - Holding technical degree/diploma etc,110,0,110,144,1,145,2,0,2,1,0,1,257,1,258
ANDHRA PRADESH,2011,Educational Standard,4377,261,4638,7964,580,8544,13,1,14,17,0,17,12371,842,13213
ANDHRA PRADESH,2011,Educational Standard - Illiterate,1579,191,1770,2562,371,2933,2,1,3,2,0,2,4145,563,4708
ANDHRA PRADESH,2011,Educational Standard - Below Class X,1660,40,1700,3682,165,3847,9,0,9,13,0,13,5364,205,5569
ANDHRA PRADESH,2011,Educational Standard - Class X and above but below graduate,803,27,830,1264,37,1301,2,0,2,2,0,2,2071,64,2135
ANDHRA PRADESH,2011,Educational Standard - Graduate,196,2,198,294,6,300,0,0,0,0,0,0,490,8,498
ANDHRA PRADESH,2011,Educational Standard - Post-Graduate,48,1,49,78,1,79,0,0,0,0,0,0,126,2,128
ANDHRA PRADESH,2011,Educational Standard - Holding technical degree/diploma etc,91,0,91,84,0,84,0,0,0,0,0,0,175,0,175
ANDHRA PRADESH,2012,Educational Standard,4437,285,4722,7914,637,8551,3,1,4,7,1,8,12361,924,13285
ANDHRA PRADESH,2012,Educational Standard - Illiterate,1506,215,1721,2556,432,2988,0,1,1,0,1,1,4062,649,4711
ANDHRA PRADESH,2012,Educational Standard - Below Class X,1699,51,1750,3295,157,3452,1,0,1,5,0,5,5000,208,5208
ANDHRA PRADESH,2012,Educational Standard - Class X and above but below graduate,795,14,809,1363,39,1402,2,0,2,2,0,2,2162,53,2215
ANDHRA PRADESH,2012,Educational Standard - Graduate,313,4,317,422,7,429,0,0,0,0,0,0,735,11,746
ANDHRA PRADESH,2012,Educational Standard - Post-Graduate,63,1,64,144,1,145,0,0,0,0,0,0,207,2,209
ANDHRA PRADESH,2012,Educational Standard - Holding technical degree/diploma etc,61,0,61,134,1,135,0,0,0,0,0,0,195,1,196
ARUNACHAL PRADESH,2009,Educational Standard,2,0,2,56,4,60,0,0,0,0,0,0,58,4,62
ARUNACHAL PRADESH,2009,Educational Standard - Illiterate,0,0,0,16,3,19,0,0,0,0,0,0,16,3,19
ARUNACHAL PRADESH,2009,Educational Standard - Below Class X,1,0,1,28,0,28,0,0,0,0,0,0,29,0,29
ARUNACHAL PRADESH,2009,Educational Standard - Class X and above but below graduate,0,0,0,11,1,12,0,0,0,0,0,0,11,1,12
ARUNACHAL PRADESH,2009,Educational Standard - Graduate,1,0,1,1,0,1,0,0,0,0,0,0,2,0,2
ARUNACHAL PRADESH,2009,Educational Standard - Post-Graduate,0,0,0,0,0,0,0,0,0,0,0,0,0,0,0
ARUNACHAL PRADESH,2009,Educational Standard - Holding technical degree/diploma etc,0,0,0,0,0,0,0,0,0,0,0,0,0,0,0
ARUNACHAL PRADESH,2010,Educational Standard,5,0,5,48,4,52,0,0,0,0,0,0,53,4,57
ARUNACHAL PRADESH,2010,Educational Standard - Illiterate,2,0,2,7,1,8,0,0,0,0,0,0,9,1,10
ARUNACHAL PRADESH,2010,Educational Standard - Below Class X,1,0,1,32,1,33,0,0,0,0,0,0,33,1,34
ARUNACHAL PRADESH,2010,Educational Standard - Class X and above but below graduate,1,0,1,8,2,10,0,0,0,0,0,0,9,2,11
ARUNACHAL PRADESH,2010,Educational Standard - Graduate,0,0,0,1,0,1,0,0,0,0,0,0,1,0,1
ARUNACHAL PRADESH,2010,Educational Standard - Post-Graduate,1,0,1,0,0,0,0,0,0,0,0,0,1,0,1
ARUNACHAL PRADESH,2010,Educational Standard - Holding technical degree/diploma etc,0,0,0,0,0,0,0,0,0,0,0,0,0,0,0
ARUNACHAL PRADESH,2011,Educational Standard,6,0,6,44,5,49,0,0,0,0,0,0,50,5,55
ARUNACHAL PRADESH,2011,Educational Standard - Illiterate,0,0,0,14,2,16,0,0,0,0,0,0,14,2,16
ARUNACHAL PRADESH,2011,Educational Standard - Below Class X,5,0,5,26,2,28,0,0,0,0,0,0,31,2,33
ARUNACHAL PRADESH,2011,Educational Standard - Class X and above but below graduate,0,0,0,3,1,4,0,0,0,0,0,0,3,1,4
ARUNACHAL PRADESH,2011,Educational Standard - Graduate,0,0,0,1,0,1,0,0,0,0,0,0,1,0,1
ARUNACHAL PRADESH,2011,Educational Standard - Post-Graduate,1,0,1,0,0,0,0,0,0,0,0,0,1,0,1
ARUNACHAL PRADESH,2011,Educational Standard - Holding technical degree/diploma etc,0,0,0,0,0,0,0,0,0,0,0,0,0,0,0
ARUNACHAL PRADESH,2012,Educational Standard,4,0,4,63,4,67,0,0,0,0,0,0,67,4,71
ARUNACHAL PRADESH,2012,Educational Standard - Illiterate,0,0,0,24,2,26,0,0,0,0,0,0,24,2,26
ARUNACHAL PRADESH,2012,Educational Standard - Below Class X,4,0,4,25,2,27,0,0,0,0,0,0,29,2,31
ARUNACHAL PRADESH,2012,Educational Standard - Class X and above but below graduate,0,0,0,13,0,13,0,0,0,0,0,0,13,0,13
ARUNACHAL PRADESH,2012,Educational Standard - Graduate,0,0,0,1,0,1,0,0,0,0,0,0,1,0,1
ARUNACHAL PRADESH,2012,Educational Standard - Post-Graduate,0,0,0,0,0,0,0,0,0,0,0,0,0,0,0
ARUNACHAL PRADESH,2012,Educational Standard - Holding technical degree/diploma etc,0,0,0,0,0,0,0,0,0,0,0,0,0,0,0
ASSAM,2001,Educational Standard,2356,47,2403,3938,127,4065,16,0,16,1,0,1,6311,174,6485
ASSAM,2001,Educational Standard - Illiterate,782,18,800,1747,70,1817,1,0,1,1,0,1,2531,88,2619
ASSAM,2001,Educational Standard - Below Class X,1172,23,1195,1567,40,1607,4,0,4,0,0,0,2743,63,2806
ASSAM,2001,Educational Standard - Class X and above but below graduate,352,6,358,557,17,574,8,0,8,0,0,0,917,23,940
ASSAM,2001,Educational Standard - Graduate,44,0,44,62,0,62,3,0,3,0,0,0,109,0,109
ASSAM,2001,Educational Standard - Post-Graduate,2,0,2,0,0,0,0,0,0,0,0,0,2,0,2
ASSAM,2001,Educational Standard - Holding technical degree/diploma etc,4,0,4,5,0,5,0,0,0,0,0,0,9,0,9
ASSAM,2002,Educational Standard,2676,54,2730,4206,113,4319,18,0,18,0,0,0,6900,167,7067
ASSAM,2002,Educational Standard - Illiterate,874,24,898,1737,41,1778,0,0,0,0,0,0,2611,65,2676
ASSAM,2002,Educational Standard - Below Class X,1389,25,1414,1790,63,1853,7,0,7,0,0,0,3186,88,3274
ASSAM,2002,Educational Standard - Class X and above but below graduate,366,5,371,579,9,588,11,0,11,0,0,0,956,14,970
ASSAM,2002,Educational Standard - Graduate,40,0,40,82,0,82,0,0,0,0,0,0,122,0,122
ASSAM,2002,Educational Standard - Post-Graduate,3,0,3,8,0,8,0,0,0,0,0,0,11,0,11
ASSAM,2002,Educational Standard - Holding technical degree/diploma etc,4,0,4,10,0,10,0,0,0,0,0,0,14,0,14
ASSAM,2003,Educational Standard,3008,72,3080,4386,137,4523,29,2,31,3,0,3,7426,211,7637
ASSAM,2003,Educational Standard - Illiterate,1143,38,1181,1795,61,1856,0,0,0,3,0,3,2941,99,3040
ASSAM,2003,Educational Standard - Below Class X,1369,30,1399,1536,51,1587,4,0,4,0,0,0,2909,81,2990
ASSAM,2003,Educational Standard - Class X and above but below graduate,455,4,459,910,17,927,21,2,23,0,0,0,1386,23,1409
ASSAM,2003,Educational Standard - Graduate,32,0,32,141,6,147,4,0,4,0,0,0,177,6,183
ASSAM,2003,Educational Standard - Post-Graduate,3,0,3,0,1,1,0,0,0,0,0,0,3,1,4
ASSAM,2003,Educational Standard - Holding technical degree/diploma etc,6,0,6,4,1,5,0,0,0,0,0,0,10,1,11
ASSAM,2004,Educational Standard,3191,77,3268,4164,134,4298,215,40,255,7,0,7,7577,251,7828
ASSAM,2004,Educational Standard - Illiterate,1099,32,1131,1534,66,1600,3,1,4,2,0,2,2638,99,2737
ASSAM,2004,Educational Standard - Below Class X,1704,39,1743,1645,44,1689,60,7,67,3,0,3,3412,90,3502
ASSAM,2004,Educational Standard - Class X and above but below graduate,331,6,337,851,21,872,123,26,149,1,0,1,1306,53,1359
ASSAM,2004,Educational Standard - Graduate,42,0,42,132,3,135,29,6,35,1,0,1,204,9,213
ASSAM,2004,Educational Standard - Post-Graduate,4,0,4,0,0,0,0,0,0,0,0,0,4,0,4
ASSAM,2004,Educational Standard - Holding technical degree/diploma etc,11,0,11,2,0,2,0,0,0,0,0,0,13,0,13
ASSAM,2005,Educational Standard,3397,78,3475,4867,133,5000,31,3,34,4,0,4,8299,214,8513
ASSAM,2005,Educational Standard - Illiterate,1130,37,1167,1876,65,1941,0,0,0,3,0,3,3009,102,3111
ASSAM,2005,Educational Standard - Below Class X,1672,36,1708,2017,60,2077,12,0,12,0,0,0,3701,96,3797
ASSAM,2005,Educational Standard - Class X and above but below graduate,549,5,554,898,7,905,16,3,19,1,0,1,1464,15,1479
ASSAM,2005,Educational Standard - Graduate,34,0,34,61,1,62,3,0,3,0,0,0,98,1,99
ASSAM,2005,Educational Standard - Post-Graduate,3,0,3,3,0,3,0,0,0,0,0,0,6,0,6
ASSAM,2005,Educational Standard - Holding technical degree/diploma etc,9,0,9,12,0,12,0,0,0,0,0,0,21,0,21
ASSAM,2006,Educational Standard,3465,84,3549,4801,159,4960,27,0,27,2,0,2,8295,243,8538
ASSAM,2006,Educational Standard - Illiterate,900,31,931,1558,70,1628,2,0,2,1,0,1,2461,101,2562
ASSAM,2006,Educational Standard - Below Class X,1956,45,2001,2174,69,2243,5,0,5,0,0,0,4135,114,4249
ASSAM,2006,Educational Standard - Class X and above but below graduate,559,8,567,950,16,966,17,0,17,1,0,1,1527,24,1551
ASSAM,2006,Educational Standard - Graduate,39,0,39,112,3,115,3,0,3,0,0,0,154,3,157
ASSAM,2006,Educational Standard - Post-Graduate,6,0,6,2,1,3,0,0,0,0,0,0,8,1,9
ASSAM,2006,Educational Standard - Holding technical degree/diploma etc,5,0,5,5,0,5,0,0,0,0,0,0,10,0,10
ASSAM,2007,Educational Standard,3480,100,3580,4944,146,5090,30,5,35,0,0,0,8454,251,8705
ASSAM,2007,Educational Standard - Illiterate,816,31,847,1802,67,1869,5,1,6,0,0,0,2623,99,2722
ASSAM,2007,Educational Standard - Below Class X,2165,59,2224,2027,51,2078,7,2,9,0,0,0,4199,112,4311
ASSAM,2007,Educational Standard - Class X and above but below graduate,444,9,453,987,27,1014,18,2,20,0,0,0,1449,38,1487
ASSAM,2007,Educational Standard - Graduate,43,1,44,96,1,97,0,0,0,0,0,0,139,2,141
ASSAM,2007,Educational Standard - Post-Graduate,3,0,3,11,0,11,0,0,0,0,0,0,14,0,14
ASSAM,2007,Educational Standard - Holding technical degree/diploma etc,9,0,9,21,0,21,0,0,0,0,0,0,30,0,30
ASSAM,2008,Educational Standard,3396,98,3494,5023,215,5238,10,0,10,0,0,0,8429,313,8742
ASSAM,2008,Educational Standard - Illiterate,930,26,956,1805,82,1887,3,0,3,0,0,0,2738,108,2846
ASSAM,2008,Educational Standard - Below Class X,1905,49,1954,2406,95,2501,4,0,4,0,0,0,4315,144,4459
ASSAM,2008,Educational Standard - Class X and above but below graduate,505,21,526,720,35,755,2,0,2,0,0,0,1227,56,1283
ASSAM,2008,Educational Standard - Graduate,45,2,47,75,3,78,1,0,1,0,0,0,121,5,126
ASSAM,2008,Educational Standard - Post-Graduate,5,0,5,9,0,9,0,0,0,0,0,0,14,0,14
ASSAM,2008,Educational Standard - Holding technical degree/diploma etc,6,0,6,8,0,8,0,0,0,0,0,0,14,0,14
ASSAM,2009,Educational Standard,3235,92,3327,4619,205,4824,7,2,9,0,0,0,7861,299,8160
ASSAM,2009,Educational Standard - Illiterate,964,34,998,1685,91,1776,2,0,2,0,0,0,2651,125,2776
ASSAM,2009,Educational Standard - Below Class X,1796,51,1847,2137,94,2231,4,2,6,0,0,0,3937,147,4084
ASSAM,2009,Educational Standard - Class X and above but below graduate,419,6,425,682,8,690,1,0,1,0,0,0,1102,14,1116
ASSAM,2009,Educational Standard - Graduate,43,1,44,92,10,102,0,0,0,0,0,0,135,11,146
ASSAM,2009,Educational Standard - Post-Graduate,3,0,3,7,2,9,0,0,0,0,0,0,10,2,12
ASSAM,2009,Educational Standard - Holding technical degree/diploma etc,10,0,10,16,0,16,0,0,0,0,0,0,26,0,26
ASSAM,2010,Educational Standard,3166,98,3264,4480,175,4655,3,0,3,0,0,0,7649,273,7922
ASSAM,2010,Educational Standard - Illiterate,858,37,895,1780,87,1867,0,0,0,0,0,0,2638,124,2762
ASSAM,2010,Educational Standard - Below Class X,1607,42,1649,1947,79,2026,2,0,2,0,0,0,3556,121,3677
ASSAM,2010,Educational Standard - Class X and above but below graduate,660,18,678,598,9,607,1,0,1,0,0,0,1259,27,1286
ASSAM,2010,Educational Standard - Graduate,28,1,29,147,0,147,0,0,0,0,0,0,175,1,176
ASSAM,2010,Educational Standard - Post-Graduate,6,0,6,5,0,5,0,0,0,0,0,0,11,0,11
ASSAM,2010,Educational Standard - Holding technical degree/diploma etc,7,0,7,3,0,3,0,0,0,0,0,0,10,0,10
ASSAM,2011,Educational Standard,3046,91,3137,4859,207,5066,0,0,0,0,0,0,7905,298,8203
ASSAM,2011,Educational Standard - Illiterate,827,35,862,1851,92,1943,0,0,0,0,0,0,2678,127,2805
ASSAM,2011,Educational Standard - Below Class X,1530,40,1570,2075,104,2179,0,0,0,0,0,0,3605,144,3749
ASSAM,2011,Educational Standard - Class X and above but below graduate,653,15,668,721,11,732,0,0,0,0,0,0,1374,26,1400
ASSAM,2011,Educational Standard - Graduate,25,1,26,197,0,197,0,0,0,0,0,0,222,1,223
ASSAM,2011,Educational Standard - Post-Graduate,5,0,5,7,0,7,0,0,0,0,0,0,12,0,12
ASSAM,2011,Educational Standard - Holding technical degree/diploma etc,6,0,6,8,0,8,0,0,0,0,0,0,14,0,14
ASSAM,2012,Educational Standard,3062,108,3170,4915,183,5098,3,0,3,0,0,0,7980,291,8271
ASSAM,2012,Educational Standard - Illiterate,849,40,889,1870,82,1952,0,0,0,0,0,0,2719,122,2841
ASSAM,2012,Educational Standard - Below Class X,1530,45,1575,2100,91,2191,1,0,1,0,0,0,3631,136,3767
ASSAM,2012,Educational Standard - Class X and above but below graduate,642,21,663,728,10,738,2,0,2,0,0,0,1372,31,1403
ASSAM,2012,Educational Standard - Graduate,26,2,28,200,0,200,0,0,0,0,0,0,226,2,228
ASSAM,2012,Educational Standard - Post-Graduate,8,0,8,8,0,8,0,0,0,0,0,0,16,0,16
ASSAM,2012,Educational Standard - Holding technical degree/diploma etc,7,0,7,9,0,9,0,0,0,0,0,0,16,0,16
BIHAR,2001,Educational Standard,4987,78,5065,30000,793,30793,12,0,12,37,0,37,35036,871,35907
BIHAR,2001,Educational Standard - Illiterate,2074,43,2117,16567,310,16877,3,0,3,4,0,4,18648,353,19001
BIHAR,2001,Educational Standard - Below Class X,1122,19,1141,6126,228,6354,2,0,2,6,0,6,7256,247,7503
BIHAR,2001,Educational Standard - Class X and above but below graduate,1001,16,1017,5031,137,5168,5,0,5,13,0,13,6050,153,6203
BIHAR,2001,Educational Standard - Graduate,705,0,705,1484,84,1568,2,0,2,9,0,9,2200,84,2284
BIHAR,2001,Educational Standard - Post-Graduate,64,0,64,688,25,713,0,0,0,5,0,5,757,25,782
BIHAR,2001,Educational Standard - Holding technical degree/diploma etc,21,0,21,104,9,113,0,0,0,0,0,0,125,9,134
BIHAR,2002,Educational Standard,4959,105,5064,31159,942,32101,33,0,33,102,0,102,36253,1047,37300
BIHAR,2002,Educational Standard - Illiterate,1675,53,1728,13139,640,13779,0,0,0,41,0,41,14855,693,15548
BIHAR,2002,Educational Standard - Below Class X,2343,45,2388,12711,271,12982,12,0,12,50,0,50,15116,316,15432
BIHAR,2002,Educational Standard - Class X and above but below graduate,713,7,720,4034,22,4056,16,0,16,9,0,9,4772,29,4801
BIHAR,2002,Educational Standard - Graduate,194,0,194,1016,3,1019,4,0,4,2,0,2,1216,3,1219
BIHAR,2002,Educational Standard - Post-Graduate,23,0,23,169,4,173,1,0,1,0,0,0,193,4,197
BIHAR,2002,Educational Standard - Holding technical degree/diploma etc,11,0,11,90,2,92,0,0,0,0,0,0,101,2,103
BIHAR,2003,Educational Standard,4974,104,5078,31189,945,32134,22,0,22,89,0,89,36274,1049,37323
BIHAR,2003,Educational Standard - Illiterate,1887,66,1953,13373,655,14028,1,0,1,27,0,27,15288,721,16009
BIHAR,2003,Educational Standard - Below Class X,2236,25,2261,11473,261,11734,17,0,17,52,0,52,13778,286,14064
BIHAR,2003,Educational Standard - Class X and above but below graduate,628,4,632,4784,27,4811,3,0,3,10,0,10,5425,31,5456
BIHAR,2003,Educational Standard - Graduate,173,0,173,1328,0,1328,1,0,1,0,0,0,1502,0,1502
BIHAR,2003,Educational Standard - Post-Graduate,36,0,36,176,0,176,0,0,0,0,0,0,212,0,212
BIHAR,2003,Educational Standard - Holding technical degree/diploma etc,14,9,23,55,2,57,0,0,0,0,0,0,69,11,80
BIHAR,2004,Educational Standard,5390,130,5520,26632,743,27375,65,0,65,113,0,113,32200,873,33073
BIHAR,2004,Educational Standard - Illiterate,1880,98,1978,10259,472,10731,8,0,8,55,0,55,12202,570,12772
BIHAR,2004,Educational Standard - Below Class X,2653,29,2682,11001,219,11220,33,0,33,44,0,44,13731,248,13979
BIHAR,2004,Educational Standard - Class X and above but below graduate,646,2,648,4130,40,4170,22,0,22,11,0,11,4809,42,4851
BIHAR,2004,Educational Standard - Graduate,162,1,163,1023,11,1034,2,0,2,3,0,3,1190,12,1202
BIHAR,2004,Educational Standard - Post-Graduate,36,0,36,166,1,167,0,0,0,0,0,0,202,1,203
BIHAR,2004,Educational Standard - Holding technical degree/diploma etc,13,0,13,53,0,53,0,0,0,0,0,0,66,0,66
BIHAR,2005,Educational Standard,5485,124,5609,38821,1198,40019,0,0,0,190,0,190,44496,1322,45818
BIHAR,2005,Educational Standard - Illiterate,138,98,236,7201,718,7919,0,0,0,8,0,8,7347,816,8163
BIHAR,2005,Educational Standard - Below Class X,3223,26,3249,29720,480,30200,0,0,0,182,0,182,33125,506,33631
BIHAR,2005,Educational Standard - Class X and above but below graduate,2124,0,2124,978,0,978,0,0,0,0,0,0,3102,0,3102
BIHAR,2005,Educational Standard - Graduate,0,0,0,922,0,922,0,0,0,0,0,0,922,0,922
BIHAR,2005,Educational Standard - Post-Graduate,0,0,0,0,0,0,0,0,0,0,0,0,0,0,0
BIHAR,2005,Educational Standard - Holding technical degree/diploma etc,0,0,0,0,0,0,0,0,0,0,0,0,0,0,0
BIHAR,2006,Educational Standard,6616,149,6765,36106,1269,37375,0,0,0,141,0,141,42863,1418,44281
BIHAR,2006,Educational Standard - Illiterate,2067,86,2153,14050,659,14709,0,0,0,40,0,40,16157,745,16902
BIHAR,2006,Educational Standard - Below Class X,3585,56,3641,14681,445,15126,0,0,0,58,0,58,18324,501,18825
BIHAR,2006,Educational Standard - Class X and above but below graduate,767,7,774,5711,154,5865,0,0,0,35,0,35,6513,161,6674
BIHAR,2006,Educational Standard - Graduate,154,0,154,1447,11,1458,0,0,0,8,0,8,1609,11,1620
BIHAR,2006,Educational Standard - Post-Graduate,27,0,27,134,0,134,0,0,0,0,0,0,161,0,161
BIHAR,2006,Educational Standard - Holding technical degree/diploma etc,16,0,16,83,0,83,0,0,0,0,0,0,99,0,99
BIHAR,2007,Educational Standard,6130,136,6266,32160,1156,33316,24,0,24,32,0,32,38346,1292,39638
BIHAR,2007,Educational Standard - Illiterate,1813,72,1885,10381,579,10960,0,0,0,5,0,5,12199,651,12850
BIHAR,2007,Educational Standard - Below Class X,3399,57,3456,15316,441,15757,0,0,0,21,0,21,18736,498,19234
BIHAR,2007,Educational Standard - Class X and above but below graduate,711,7,718,4957,126,5083,15,0,15,4,0,4,5687,133,5820
BIHAR,2007,Educational Standard - Graduate,163,0,163,1298,10,1308,7,0,7,2,0,2,1470,10,1480
BIHAR,2007,Educational Standard - Post-Graduate,26,0,26,123,0,123,2,0,2,0,0,0,151,0,151
BIHAR,2007,Educational Standard - Holding technical degree/diploma etc,18,0,18,85,0,85,0,0,0,0,0,0,103,0,103
BIHAR,2008,Educational Standard,5868,131,5999,30549,1098,31647,24,0,24,39,0,39,36480,1229,37709
BIHAR,2008,Educational Standard - Illiterate,1691,71,1762,8791,526,9317,0,0,0,7,0,7,10489,597,11086
BIHAR,2008,Educational Standard - Below Class X,3294,50,3344,15272,427,15699,0,0,0,22,0,22,18588,477,19065
BIHAR,2008,Educational Standard - Class X and above but below graduate,702,8,710,5077,130,5207,17,0,17,5,0,5,5801,138,5939
BIHAR,2008,Educational Standard - Graduate,140,2,142,1201,13,1214,4,0,4,5,0,5,1350,15,1365
BIHAR,2008,Educational Standard - Post-Graduate,23,0,23,120,2,122,3,0,3,0,0,0,146,2,148
BIHAR,2008,Educational Standard - Holding technical degree/diploma etc,18,0,18,88,0,88,0,0,0,0,0,0,106,0,106
BIHAR,2009,Educational Standard,5423,108,5531,27246,917,28163,10,0,10,6,1,7,32685,1026,33711
BIHAR,2009,Educational Standard - Illiterate,1821,62,1883,8360,444,8804,0,0,0,1,0,1,10182,506,10688
BIHAR,2009,Educational Standard - Below Class X,2814,37,2851,13719,351,14070,3,0,3,2,1,3,16538,389,16927
BIHAR,2009,Educational Standard - Class X and above but below graduate,643,7,650,3952,108,4060,3,0,3,3,0,3,4601,115,4716
BIHAR,2009,Educational Standard - Graduate,112,2,114,1024,11,1035,3,0,3,0,0,0,1139,13,1152
BIHAR,2009,Educational Standard - Post-Graduate,19,0,19,119,3,122,1,0,1,0,0,0,139,3,142
BIHAR,2009,Educational Standard - Holding technical degree/diploma etc,14,0,14,72,0,72,0,0,0,0,0,0,86,0,86
BIHAR,2010,Educational Standard,5166,119,5285,23589,773,24362,34,0,34,19,0,19,28808,892,29700
BIHAR,2010,Educational Standard - Illiterate,1488,49,1537,8062,380,8442,0,0,0,4,0,4,9554,429,9983
BIHAR,2010,Educational Standard - Below Class X,2966,53,3019,11272,310,11582,6,0,6,10,0,10,14254,363,14617
BIHAR,2010,Educational Standard - Class X and above but below graduate,579,13,592,3197,75,3272,18,0,18,5,0,5,3799,88,3887
BIHAR,2010,Educational Standard - Graduate,103,4,107,905,7,912,8,0,8,0,0,0,1016,11,1027
BIHAR,2010,Educational Standard - Post-Graduate,18,0,18,97,1,98,2,0,2,0,0,0,117,1,118
BIHAR,2010,Educational Standard - Holding technical degree/diploma etc,12,0,12,56,0,56,0,0,0,0,0,0,68,0,68
BIHAR,2011,Educational Standard,4508,86,4594,22622,795,23417,8,0,8,13,0,13,27151,881,28032
BIHAR,2011,Educational Standard - Illiterate,1281,43,1324,7011,395,7406,3,0,3,3,0,3,8298,438,8736
BIHAR,2011,Educational Standard - Below Class X,2042,39,2081,9327,333,9660,2,0,2,6,0,6,11377,372,11749
BIHAR,2011,Educational Standard - Class X and above but below graduate,907,3,910,4788,52,4840,3,0,3,1,0,1,5699,55,5754
BIHAR,2011,Educational Standard - Graduate,225,1,226,1245,9,1254,0,0,0,2,0,2,1472,10,1482
BIHAR,2011,Educational Standard - Post-Graduate,41,0,41,190,6,196,0,0,0,1,0,1,232,6,238
BIHAR,2011,Educational Standard - Holding technical degree/diploma etc,12,0,12,61,0,61,0,0,0,0,0,0,73,0,73
BIHAR,2012,Educational Standard,4006,102,4108,23563,826,24389,40,0,40,13,0,13,27622,928,28550
BIHAR,2012,Educational Standard - Illiterate,1122,47,1169,7529,464,7993,5,0,5,5,0,5,8661,511,9172
BIHAR,2012,Educational Standard - Below Class X,1891,51,1942,9584,303,9887,20,0,20,6,0,6,11501,354,11855
BIHAR,2012,Educational Standard - Class X and above but below graduate,787,3,790,4939,53,4992,12,0,12,2,0,2,5740,56,5796
BIHAR,2012,Educational Standard - Graduate,170,1,171,1243,3,1246,3,0,3,0,0,0,1416,4,1420
BIHAR,2012,Educational Standard - Post-Graduate,26,0,26,184,3,187,0,0,0,0,0,0,210,3,213
BIHAR,2012,Educational Standard - Holding technical degree/diploma etc,10,0,10,84,0,84,0,0,0,0,0,0,94,0,94
CHHATTISGARH,2012,Educational Standard,5720,244,5964,8344,455,8799,0,0,0,17,0,17,14081,699,14780
CHHATTISGARH,2012,Educational Standard - Illiterate,2158,116,2274,2955,253,3208,0,0,0,7,0,7,5120,369,5489
CHHATTISGARH,2012,Educational Standard - Below Class X,2627,114,2741,3780,156,3936,0,0,0,9,0,9,6416,270,6686
CHHATTISGARH,2012,Educational Standard - Class X and above but below graduate,708,9,717,1108,19,1127,0,0,0,1,0,1,1817,28,1845
CHHATTISGARH,2012,Educational Standard - Graduate,127,3,130,337,13,350,0,0,0,0,0,0,464,16,480
CHHATTISGARH,2012,Educational Standard - Post-Graduate,66,2,68,140,13,153,0,0,0,0,0,0,206,15,221
CHHATTISGARH,2012,Educational Standard - Holding technical degree/diploma etc,34,0,34,24,1,25,0,0,0,0,0,0,58,1,59
CHHATTISGARH,2001,Educational Standard,4548,185,4733,4717,204,4921,4,0,4,8,1,9,9277,390,9667
CHHATTISGARH,2001,Educational Standard - Illiterate,1642,103,1745,1704,129,1833,0,0,0,3,1,4,3349,233,3582
CHHATTISGARH,2001,Educational Standard - Below Class X,2112,70,2182,2165,66,2231,3,0,3,5,0,5,4285,136,4421
CHHATTISGARH,2001,Educational Standard - Class X and above but below graduate,580,11,591,636,9,645,1,0,1,0,0,0,1217,20,1237
CHHATTISGARH,2001,Educational Standard - Graduate,163,1,164,125,0,125,0,0,0,0,0,0,288,1,289
CHHATTISGARH,2001,Educational Standard - Post-Graduate,41,0,41,74,0,74,0,0,0,0,0,0,115,0,115
CHHATTISGARH,2001,Educational Standard - Holding technical degree/diploma etc,10,0,10,13,0,13,0,0,0,0,0,0,23,0,23
CHHATTISGARH,2002,Educational Standard,4834,202,5036,4736,225,4961,1,0,1,8,0,8,9579,427,10006
CHHATTISGARH,2002,Educational Standard - Illiterate,1413,103,1516,1632,132,1764,0,0,0,4,0,4,3049,235,3284
CHHATTISGARH,2002,Educational Standard - Below Class X,2621,79,2700,1985,73,2058,1,0,1,4,0,4,4611,152,4763
CHHATTISGARH,2002,Educational Standard - Class X and above but below graduate,639,17,656,837,18,855,0,0,0,0,0,0,1476,35,1511
CHHATTISGARH,2002,Educational Standard - Graduate,107,2,109,176,2,178,0,0,0,0,0,0,283,4,287
CHHATTISGARH,2002,Educational Standard - Post-Graduate,43,1,44,101,0,101,0,0,0,0,0,0,144,1,145
CHHATTISGARH,2002,Educational Standard - Holding technical degree/diploma etc,11,0,11,5,0,5,0,0,0,0,0,0,16,0,16
CHHATTISGARH,2003,Educational Standard,4521,199,4720,3968,160,4128,3,0,3,10,0,10,8502,359,8861
CHHATTISGARH,2003,Educational Standard - Illiterate,1480,91,1571,1659,113,1772,1,0,1,3,0,3,3143,204,3347
CHHATTISGARH,2003,Educational Standard - Below Class X,2433,88,2521,1661,34,1695,2,0,2,5,0,5,4101,122,4223
CHHATTISGARH,2003,Educational Standard - Class X and above but below graduate,540,17,557,519,11,530,0,0,0,2,0,2,1061,28,1089
CHHATTISGARH,2003,Educational Standard - Graduate,48,2,50,77,1,78,0,0,0,0,0,0,125,3,128
CHHATTISGARH,2003,Educational Standard - Post-Graduate,18,1,19,25,1,26,0,0,0,0,0,0,43,2,45
CHHATTISGARH,2003,Educational Standard - Holding technical degree/diploma etc,2,0,2,27,0,27,0,0,0,0,0,0,29,0,29
CHHATTISGARH,2004,Educational Standard,4320,205,4525,4143,194,4337,0,0,0,11,0,11,8474,399,8873
CHHATTISGARH,2004,Educational Standard - Illiterate,1841,107,1948,1743,131,1874,0,0,0,5,0,5,3589,238,3827
CHHATTISGARH,2004,Educational Standard - Below Class X,1456,73,1529,1747,50,1797,0,0,0,5,0,5,3208,123,3331
CHHATTISGARH,2004,Educational Standard - Class X and above but below graduate,874,20,894,444,11,455,0,0,0,1,0,1,1319,31,1350
CHHATTISGARH,2004,Educational Standard - Graduate,77,5,82,142,2,144,0,0,0,0,0,0,219,7,226
CHHATTISGARH,2004,Educational Standard - Post-Graduate,51,0,51,48,0,48,0,0,0,0,0,0,99,0,99
CHHATTISGARH,2004,Educational Standard - Holding technical degree/diploma etc,21,0,21,19,0,19,0,0,0,0,0,0,40,0,40
CHHATTISGARH,2005,Educational Standard,4108,191,4299,5277,232,5509,2,0,2,11,0,11,9398,423,9821
CHHATTISGARH,2005,Educational Standard - Illiterate,1485,114,1599,2219,152,2371,0,0,0,0,0,0,3704,266,3970
CHHATTISGARH,2005,Educational Standard - Below Class X,1553,46,1599,2260,52,2312,1,0,1,9,0,9,3823,98,3921
CHHATTISGARH,2005,Educational Standard - Class X and above but below graduate,626,26,652,551,26,577,1,0,1,2,0,2,1180,52,1232
CHHATTISGARH,2005,Educational Standard - Graduate,299,3,302,189,2,191,0,0,0,0,0,0,488,5,493
CHHATTISGARH,2005,Educational Standard - Post-Graduate,122,2,124,44,0,44,0,0,0,0,0,0,166,2,168
CHHATTISGARH,2005,Educational Standard - Holding technical degree/diploma etc,23,0,23,14,0,14,0,0,0,0,0,0,37,0,37
CHHATTISGARH,2006,Educational Standard,4087,187,4274,5789,284,6073,1,0,1,11,0,11,9888,471,10359
CHHATTISGARH,2006,Educational Standard - Illiterate,1435,104,1539,2288,176,2464,1,0,1,2,0,2,3726,280,4006
CHHATTISGARH,2006,Educational Standard - Below Class X,1571,47,1618,2437,71,2508,0,0,0,4,0,4,4012,118,4130
CHHATTISGARH,2006,Educational Standard - Class X and above but below graduate,617,30,647,698,29,727,0,0,0,5,0,5,1320,59,1379
CHHATTISGARH,2006,Educational Standard - Graduate,312,3,315,230,8,238,0,0,0,0,0,0,542,11,553
CHHATTISGARH,2006,Educational Standard - Post-Graduate,126,3,129,105,0,105,0,0,0,0,0,0,231,3,234
CHHATTISGARH,2006,Educational Standard - Holding technical degree/diploma etc,26,0,26,31,0,31,0,0,0,0,0,0,57,0,57
CHHATTISGARH,2007,Educational Standard,4317,208,4525,5646,253,5899,0,0,0,27,0,27,9990,461,10451
CHHATTISGARH,2007,Educational Standard - Illiterate,1413,116,1529,2126,156,2282,0,0,0,12,0,12,3551,272,3823
CHHATTISGARH,2007,Educational Standard - Below Class X,1729,53,1782,2323,75,2398,0,0,0,12,0,12,4064,128,4192
CHHATTISGARH,2007,Educational Standard - Class X and above but below graduate,685,35,720,847,20,867,0,0,0,2,0,2,1534,55,1589
CHHATTISGARH,2007,Educational Standard - Graduate,321,2,323,217,2,219,0,0,0,1,0,1,539,4,543
CHHATTISGARH,2007,Educational Standard - Post-Graduate,146,2,148,101,0,101,0,0,0,0,0,0,247,2,249
CHHATTISGARH,2007,Educational Standard - Holding technical degree/diploma etc,23,0,23,32,0,32,0,0,0,0,0,0,55,0,55
CHHATTISGARH,2008,Educational Standard,4573,194,4767,6155,302,6457,0,0,0,6,0,6,10734,496,11230
CHHATTISGARH,2008,Educational Standard - Illiterate,1664,111,1775,2398,181,2579,0,0,0,0,0,0,4062,292,4354
CHHATTISGARH,2008,Educational Standard - Below Class X,1656,49,1705,2457,85,2542,0,0,0,5,0,5,4118,134,4252
CHHATTISGARH,2008,Educational Standard - Class X and above but below graduate,745,31,776,956,31,987,0,0,0,1,0,1,1702,62,1764
CHHATTISGARH,2008,Educational Standard - Graduate,328,2,330,208,3,211,0,0,0,0,0,0,536,5,541
CHHATTISGARH,2008,Educational Standard - Post-Graduate,147,1,148,107,2,109,0,0,0,0,0,0,254,3,257
CHHATTISGARH,2008,Educational Standard - Holding technical degree/diploma etc,33,0,33,29,0,29,0,0,0,0,0,0,62,0,62
CHHATTISGARH,2009,Educational Standard,4640,217,4857,6910,359,7269,0,0,0,16,0,16,11566,576,12142
CHHATTISGARH,2009,Educational Standard - Illiterate,1466,133,1599,2650,179,2829,0,0,0,13,0,13,4129,312,4441
CHHATTISGARH,2009,Educational Standard - Below Class X,2348,63,2411,3001,126,3127,0,0,0,3,0,3,5352,189,5541
CHHATTISGARH,2009,Educational Standard - Class X and above but below graduate,603,20,623,960,36,996,0,0,0,0,0,0,1563,56,1619
CHHATTISGARH,2009,Educational Standard - Graduate,127,0,127,194,6,200,0,0,0,0,0,0,321,6,327
CHHATTISGARH,2009,Educational Standard - Post-Graduate,76,1,77,70,11,81,0,0,0,0,0,0,146,12,158
CHHATTISGARH,2009,Educational Standard - Holding technical degree/diploma etc,20,0,20,35,1,36,0,0,0,0,0,0,55,1,56
CHHATTISGARH,2010,Educational Standard,4987,209,5196,7324,375,7699,1,0,1,19,0,19,12331,584,12915
CHHATTISGARH,2010,Educational Standard - Illiterate,1511,85,1596,2329,210,2539,0,0,0,7,0,7,3847,295,4142
CHHATTISGARH,2010,Educational Standard - Below Class X,2448,99,2547,3601,120,3721,1,0,1,12,0,12,6062,219,6281
CHHATTISGARH,2010,Educational Standard - Class X and above but below graduate,761,24,785,1023,29,1052,0,0,0,0,0,0,1784,53,1837
CHHATTISGARH,2010,Educational Standard - Graduate,159,1,160,245,3,248,0,0,0,0,0,0,404,4,408
CHHATTISGARH,2010,Educational Standard - Post-Graduate,80,0,80,96,10,106,0,0,0,0,0,0,176,10,186
CHHATTISGARH,2010,Educational Standard - Holding technical degree/diploma etc,28,0,28,30,3,33,0,0,0,0,0,0,58,3,61
CHHATTISGARH,2011,Educational Standard,5388,242,5630,7883,392,8275,0,0,0,13,0,13,13284,634,13918
CHHATTISGARH,2011,Educational Standard - Illiterate,1529,119,1648,2631,203,2834,0,0,0,5,0,5,4165,322,4487
CHHATTISGARH,2011,Educational Standard - Below Class X,2781,112,2893,3564,134,3698,0,0,0,7,0,7,6352,246,6598
CHHATTISGARH,2011,Educational Standard - Class X and above but below graduate,794,10,804,1120,33,1153,0,0,0,1,0,1,1915,43,1958
CHHATTISGARH,2011,Educational Standard - Graduate,158,0,158,323,8,331,0,0,0,0,0,0,481,8,489
CHHATTISGARH,2011,Educational Standard - Post-Graduate,96,1,97,145,13,158,0,0,0,0,0,0,241,14,255
CHHATTISGARH,2011,Educational Standard - Holding technical degree/diploma etc,30,0,30,100,1,101,0,0,0,0,0,0,130,1,131
GOA,2001,Educational Standard,154,4,158,287,7,294,0,0,0,0,0,0,441,11,452
GOA,2001,Educational Standard - Illiterate,75,2,77,112,5,117,0,0,0,0,0,0,187,7,194
GOA,2001,Educational Standard - Below Class X,70,2,72,137,1,138,0,0,0,0,0,0,207,3,210
GOA,2001,Educational Standard - Class X and above but below graduate,9,0,9,30,1,31,0,0,0,0,0,0,39,1,40
GOA,2001,Educational Standard - Graduate,0,0,0,8,0,8,0,0,0,0,0,0,8,0,8
GOA,2001,Educational Standard - Post-Graduate,0,0,0,0,0,0,0,0,0,0,0,0,0,0,0
GOA,2001,Educational Standard - Holding technical degree/diploma etc,0,0,0,0,0,0,0,0,0,0,0,0,0,0,0
GOA,2002,Educational Standard,145,4,149,198,5,203,0,0,0,0,0,0,343,9,352
GOA,2002,Educational Standard - Illiterate,68,0,68,58,5,63,0,0,0,0,0,0,126,5,131
GOA,2002,Educational Standard - Below Class X,47,4,51,97,0,97,0,0,0,0,0,0,144,4,148
GOA,2002,Educational Standard - Class X and above but below graduate,20,0,20,35,0,35,0,0,0,0,0,0,55,0,55
GOA,2002,Educational Standard - Graduate,10,0,10,6,0,6,0,0,0,0,0,0,16,0,16
GOA,2002,Educational Standard - Post-Graduate,0,0,0,0,0,0,0,0,0,0,0,0,0,0,0
GOA,2002,Educational Standard - Holding technical degree/diploma etc,0,0,0,2,0,2,0,0,0,0,0,0,2,0,2
GOA,2003,Educational Standard,140,3,143,379,9,388,1,0,1,0,0,0,520,12,532
GOA,2003,Educational Standard - Illiterate,56,2,58,126,9,135,1,0,1,0,0,0,183,11,194
GOA,2003,Educational Standard - Below Class X,41,1,42,192,0,192,0,0,0,0,0,0,233,1,234
GOA,2003,Educational Standard - Class X and above but below graduate,38,0,38,43,0,43,0,0,0,0,0,0,81,0,81
GOA,2003,Educational Standard - Graduate,5,0,5,14,0,14,0,0,0,0,0,0,19,0,19
GOA,2003,Educational Standard - Post-Graduate,0,0,0,0,0,0,0,0,0,0,0,0,0,0,0
GOA,2003,Educational Standard - Holding technical degree/diploma etc,0,0,0,4,0,4,0,0,0,0,0,0,4,0,4
GOA,2004,Educational Standard,148,2,150,268,9,277,0,0,0,0,0,0,416,11,427
GOA,2004,Educational Standard - Illiterate,10,0,10,40,0,40,0,0,0,0,0,0,50,0,50
GOA,2004,Educational Standard - Below Class X,115,2,117,188,9,197,0,0,0,0,0,0,303,11,314
GOA,2004,Educational Standard - Class X and above but below graduate,23,0,23,33,0,33,0,0,0,0,0,0,56,0,56
GOA,2004,Educational Standard - Graduate,0,0,0,7,0,7,0,0,0,0,0,0,7,0,7
GOA,2004,Educational Standard - Post-Graduate,0,0,0,0,0,0,0,0,0,0,0,0,0,0,0
GOA,2004,Educational Standard - Holding technical degree/diploma etc,0,0,0,0,0,0,0,0,0,0,0,0,0,0,0
GOA,2005,Educational Standard,135,3,138,229,17,246,0,0,0,0,0,0,364,20,384
GOA,2005,Educational Standard - Illiterate,16,1,17,53,10,63,0,0,0,0,0,0,69,11,80
GOA,2005,Educational Standard - Below Class X,104,2,106,129,7,136,0,0,0,0,0,0,233,9,242
GOA,2005,Educational Standard - Class X and above but below graduate,8,0,8,40,0,40,0,0,0,0,0,0,48,0,48
GOA,2005,Educational Standard - Graduate,7,0,7,5,0,5,0,0,0,0,0,0,12,0,12
GOA,2005,Educational Standard - Post-Graduate,0,0,0,0,0,0,0,0,0,0,0,0,0,0,0
GOA,2005,Educational Standard - Holding technical degree/diploma etc,0,0,0,2,0,2,0,0,0,0,0,0,2,0,2
GOA,2006,Educational Standard,142,2,144,218,18,236,0,0,0,0,0,0,360,20,380
GOA,2006,Educational Standard - Illiterate,18,0,18,66,5,71,0,0,0,0,0,0,84,5,89
GOA,2006,Educational Standard - Below Class X,92,2,94,91,13,104,0,0,0,0,0,0,183,15,198
GOA,2006,Educational Standard - Class X and above but below graduate,27,0,27,35,0,35,0,0,0,0,0,0,62,0,62
GOA,2006,Educational Standard - Graduate,5,0,5,17,0,17,0,0,0,0,0,0,22,0,22
GOA,2006,Educational Standard - Post-Graduate,0,0,0,7,0,7,0,0,0,0,0,0,7,0,7
GOA,2006,Educational Standard - Holding technical degree/diploma etc,0,0,0,2,0,2,0,0,0,0,0,0,2,0,2
GOA,2007,Educational Standard,145,2,147,201,18,219,0,0,0,0,0,0,346,20,366
GOA,2007,Educational Standard - Illiterate,24,1,25,66,2,68,0,0,0,0,0,0,90,3,93
GOA,2007,Educational Standard - Below Class X,77,1,78,83,16,99,0,0,0,0,0,0,160,17,177
GOA,2007,Educational Standard - Class X and above but below graduate,31,0,31,35,0,35,0,0,0,0,0,0,66,0,66
GOA,2007,Educational Standard - Graduate,13,0,13,16,0,16,0,0,0,0,0,0,29,0,29
GOA,2007,Educational Standard - Post-Graduate,0,0,0,1,0,1,0,0,0,0,0,0,1,0,1
GOA,2007,Educational Standard - Holding technical degree/diploma etc,0,0,0,0,0,0,0,0,0,0,0,0,0,0,0
GOA,2008,Educational Standard,141,9,150,237,16,253,0,0,0,0,0,0,378,25,403
GOA,2008,Educational Standard - Illiterate,14,5,19,110,6,116,0,0,0,0,0,0,124,11,135
GOA,2008,Educational Standard - Below Class X,100,4,104,78,10,88,0,0,0,0,0,0,178,14,192
GOA,2008,Educational Standard - Class X and above but below graduate,17,0,17,47,0,47,0,0,0,0,0,0,64,0,64
GOA,2008,Educational Standard - Graduate,9,0,9,2,0,2,0,0,0,0,0,0,11,0,11
GOA,2008,Educational Standard - Post-Graduate,0,0,0,0,0,0,0,0,0,0,0,0,0,0,0
GOA,2008,Educational Standard - Holding technical degree/diploma etc,1,0,1,0,0,0,0,0,0,0,0,0,1,0,1
GOA,2009,Educational Standard,181,7,188,220,24,244,0,0,0,0,0,0,401,31,432
GOA,2009,Educational Standard - Illiterate,17,5,22,105,14,119,0,0,0,0,0,0,122,19,141
GOA,2009,Educational Standard - Below Class X,127,2,129,79,10,89,0,0,0,0,0,0,206,12,218
GOA,2009,Educational Standard - Class X and above but below graduate,26,0,26,27,0,27,0,0,0,0,0,0,53,0,53
GOA,2009,Educational Standard - Graduate,11,0,11,8,0,8,0,0,0,0,0,0,19,0,19
GOA,2009,Educational Standard - Post-Graduate,0,0,0,0,0,0,0,0,0,0,0,0,0,0,0
GOA,2009,Educational Standard - Holding technical degree/diploma etc,0,0,0,1,0,1,0,0,0,0,0,0,1,0,1
GOA,2010,Educational Standard,169,8,177,252,27,279,0,0,0,0,0,0,421,35,456
GOA,2010,Educational Standard - Illiterate,20,5,25,70,10,80,0,0,0,0,0,0,90,15,105
GOA,2010,Educational Standard - Below Class X,104,3,107,93,15,108,0,0,0,0,0,0,197,18,215
GOA,2010,Educational Standard - Class X and above but below graduate,35,0,35,56,2,58,0,0,0,0,0,0,91,2,93
GOA,2010,Educational Standard - Graduate,10,0,10,27,0,27,0,0,0,0,0,0,37,0,37
GOA,2010,Educational Standard - Post-Graduate,0,0,0,2,0,2,0,0,0,0,0,0,2,0,2
GOA,2010,Educational Standard - Holding technical degree/diploma etc,0,0,0,4,0,4,0,0,0,0,0,0,4,0,4
GOA,2011,Educational Standard,138,6,144,317,28,345,0,0,0,0,0,0,455,34,489
GOA,2011,Educational Standard - Illiterate,26,5,31,107,9,116,0,0,0,0,0,0,133,14,147
GOA,2011,Educational Standard - Below Class X,79,1,80,133,16,149,0,0,0,0,0,0,212,17,229
GOA,2011,Educational Standard - Class X and above but below graduate,22,0,22,53,2,55,0,0,0,0,0,0,75,2,77
GOA,2011,Educational Standard - Graduate,10,0,10,17,1,18,0,0,0,0,0,0,27,1,28
GOA,2011,Educational Standard - Post-Graduate,0,0,0,1,0,1,0,0,0,0,0,0,1,0,1
GOA,2011,Educational Standard - Holding technical degree/diploma etc,1,0,1,6,0,6,0,0,0,0,0,0,7,0,7
GOA,2012,Educational Standard,132,4,136,312,24,336,0,0,0,0,0,0,444,28,472
GOA,2012,Educational Standard - Illiterate,15,2,17,99,5,104,0,0,0,0,0,0,114,7,121
GOA,2012,Educational Standard - Below Class X,74,1,75,143,17,160,0,0,0,0,0,0,217,18,235
GOA,2012,Educational Standard - Class X and above but below graduate,32,0,32,45,2,47,0,0,0,0,0,0,77,2,79
GOA,2012,Educational Standard - Graduate,11,1,12,18,0,18,0,0,0,0,0,0,29,1,30
GOA,2012,Educational Standard - Post-Graduate,0,0,0,1,0,1,0,0,0,0,0,0,1,0,1
GOA,2012,Educational Standard - Holding technical degree/diploma etc,0,0,0,6,0,6,0,0,0,0,0,0,6,0,6
GUJARAT,2001,Educational Standard,2858,58,2916,5418,139,5557,420,30,450,0,0,0,8696,227,8923
GUJARAT,2001,Educational Standard - Illiterate,948,20,968,2285,92,2377,130,19,149,0,0,0,3363,131,3494
GUJARAT,2001,Educational Standard - Below Class X,1304,30,1334,2307,44,2351,190,11,201,0,0,0,3801,85,3886
GUJARAT,2001,Educational Standard - Class X and above but below graduate,531,6,537,577,2,579,85,0,85,0,0,0,1193,8,1201
GUJARAT,2001,Educational Standard - Graduate,68,2,70,128,1,129,15,0,15,0,0,0,211,3,214
GUJARAT,2001,Educational Standard - Post-Graduate,4,0,4,62,0,62,0,0,0,0,0,0,66,0,66
GUJARAT,2001,Educational Standard - Holding technical degree/diploma etc,3,0,3,59,0,59,0,0,0,0,0,0,62,0,62
GUJARAT,2002,Educational Standard,3194,92,3286,6182,187,6369,547,45,592,0,0,0,9923,324,10247
GUJARAT,2002,Educational Standard - Illiterate,946,34,980,2817,113,2930,198,20,218,0,0,0,3961,167,4128
GUJARAT,2002,Educational Standard - Below Class X,1500,45,1545,2187,60,2247,208,20,228,0,0,0,3895,125,4020
GUJARAT,2002,Educational Standard - Class X and above but below graduate,499,9,508,790,12,802,120,5,125,0,0,0,1409,26,1435
GUJARAT,2002,Educational Standard - Graduate,154,4,158,290,2,292,19,0,19,0,0,0,463,6,469
GUJARAT,2002,Educational Standard - Post-Graduate,58,0,58,76,0,76,2,0,2,0,0,0,136,0,136
GUJARAT,2002,Educational Standard - Holding technical degree/diploma etc,37,0,37,22,0,22,0,0,0,0,0,0,59,0,59
GUJARAT,2003,Educational Standard,3311,117,3428,6187,234,6421,325,52,377,0,0,0,9823,403,10226
GUJARAT,2003,Educational Standard - Illiterate,1096,53,1149,3031,119,3150,70,19,89,0,0,0,4197,191,4388
GUJARAT,2003,Educational Standard - Below Class X,1460,50,1510,2278,97,2375,114,20,134,0,0,0,3852,167,4019
GUJARAT,2003,Educational Standard - Class X and above but below graduate,358,10,368,565,15,580,71,12,83,0,0,0,994,37,1031
GUJARAT,2003,Educational Standard - Graduate,200,4,204,199,3,202,40,1,41,0,0,0,439,8,447
GUJARAT,2003,Educational Standard - Post-Graduate,120,0,120,79,0,79,21,0,21,0,0,0,220,0,220
GUJARAT,2003,Educational Standard - Holding technical degree/diploma etc,77,0,77,35,0,35,9,0,9,0,0,0,121,0,121
GUJARAT,2004,Educational Standard,3739,142,3881,6905,297,7202,431,56,487,0,0,0,11075,495,11570
GUJARAT,2004,Educational Standard - Illiterate,1191,118,1309,3099,187,3286,139,30,169,0,0,0,4429,335,4764
GUJARAT,2004,Educational Standard - Below Class X,1780,23,1803,2700,95,2795,215,26,241,0,0,0,4695,144,4839
GUJARAT,2004,Educational Standard - Class X and above but below graduate,427,1,428,640,12,652,52,0,52,0,0,0,1119,13,1132
GUJARAT,2004,Educational Standard - Graduate,270,0,270,305,3,308,25,0,25,0,0,0,600,3,603
GUJARAT,2004,Educational Standard - Post-Graduate,44,0,44,84,0,84,0,0,0,0,0,0,128,0,128
GUJARAT,2004,Educational Standard - Holding technical degree/diploma etc,27,0,27,77,0,77,0,0,0,0,0,0,104,0,104
GUJARAT,2005,Educational Standard,4298,147,4445,6205,246,6451,303,17,320,0,0,0,10806,410,11216
GUJARAT,2005,Educational Standard - Illiterate,1911,115,2026,2779,137,2916,107,12,119,0,0,0,4797,264,5061
GUJARAT,2005,Educational Standard - Below Class X,1697,28,1725,2383,86,2469,128,2,130,0,0,0,4208,116,4324
GUJARAT,2005,Educational Standard - Class X and above but below graduate,576,4,580,857,19,876,43,3,46,0,0,0,1476,26,1502
GUJARAT,2005,Educational Standard - Graduate,95,0,95,170,4,174,24,0,24,0,0,0,289,4,293
GUJARAT,2005,Educational Standard - Post-Graduate,0,0,0,12,0,12,0,0,0,0,0,0,12,0,12
GUJARAT,2005,Educational Standard - Holding technical degree/diploma etc,19,0,19,4,0,4,1,0,1,0,0,0,24,0,24
GUJARAT,2006,Educational Standard,4868,160,5028,6098,289,6387,329,49,378,0,0,0,11295,498,11793
GUJARAT,2006,Educational Standard - Illiterate,2509,119,2628,2817,151,2968,81,31,112,0,0,0,5407,301,5708
GUJARAT,2006,Educational Standard - Below Class X,1493,36,1529,2532,115,2647,191,17,208,0,0,0,4216,168,4384
GUJARAT,2006,Educational Standard - Class X and above but below graduate,598,3,601,516,15,531,43,1,44,0,0,0,1157,19,1176
GUJARAT,2006,Educational Standard - Graduate,196,2,198,159,4,163,13,0,13,0,0,0,368,6,374
GUJARAT,2006,Educational Standard - Post-Graduate,72,0,72,56,2,58,0,0,0,0,0,0,128,2,130
GUJARAT,2006,Educational Standard - Holding technical degree/diploma etc,0,0,0,18,2,20,1,0,1,0,0,0,19,2,21
GUJARAT,2007,Educational Standard,4876,193,5069,5589,297,5886,712,175,887,0,0,0,11177,665,11842
GUJARAT,2007,Educational Standard - Illiterate,2381,144,2525,2289,179,2468,270,126,396,0,0,0,4940,449,5389
GUJARAT,2007,Educational Standard - Below Class X,1524,40,1564,2103,90,2193,303,45,348,0,0,0,3930,175,4105
GUJARAT,2007,Educational Standard - Class X and above but below graduate,815,7,822,963,27,990,104,4,108,0,0,0,1882,38,1920
GUJARAT,2007,Educational Standard - Graduate,107,2,109,199,1,200,28,0,28,0,0,0,334,3,337
GUJARAT,2007,Educational Standard - Post-Graduate,48,0,48,28,0,28,7,0,7,0,0,0,83,0,83
GUJARAT,2007,Educational Standard - Holding technical degree/diploma etc,1,0,1,7,0,7,0,0,0,0,0,0,8,0,8
GUJARAT,2008,Educational Standard,4719,208,4927,6680,291,6971,335,46,381,0,0,0,11734,545,12279
GUJARAT,2008,Educational Standard - Illiterate,2009,132,2141,2422,158,2580,82,30,112,0,0,0,4513,320,4833
GUJARAT,2008,Educational Standard - Below Class X,2051,60,2111,2668,89,2757,186,16,202,0,0,0,4905,165,5070
GUJARAT,2008,Educational Standard - Class X and above but below graduate,424,9,433,1072,36,1108,56,0,56,0,0,0,1552,45,1597
GUJARAT,2008,Educational Standard - Graduate,136,7,143,410,6,416,10,0,10,0,0,0,556,13,569
GUJARAT,2008,Educational Standard - Post-Graduate,57,0,57,69,2,71,0,0,0,0,0,0,126,2,128
GUJARAT,2008,Educational Standard - Holding technical degree/diploma etc,42,0,42,39,0,39,1,0,1,0,0,0,82,0,82
GUJARAT,2009,Educational Standard,4196,184,4380,6865,341,7206,297,59,356,0,0,0,11358,584,11942
GUJARAT,2009,Educational Standard - Illiterate,1863,123,1986,2944,214,3158,132,30,162,0,0,0,4939,367,5306
GUJARAT,2009,Educational Standard - Below Class X,1769,48,1817,2804,113,2917,103,25,128,0,0,0,4676,186,4862
GUJARAT,2009,Educational Standard - Class X and above but below graduate,415,7,422,711,13,724,19,1,20,0,0,0,1145,21,1166
GUJARAT,2009,Educational Standard - Graduate,75,6,81,350,1,351,43,3,46,0,0,0,468,10,478
GUJARAT,2009,Educational Standard - Post-Graduate,39,0,39,46,0,46,0,0,0,0,0,0,85,0,85
GUJARAT,2009,Educational Standard - Holding technical degree/diploma etc,35,0,35,10,0,10,0,0,0,0,0,0,45,0,45
GUJARAT,2010,Educational Standard,4183,191,4374,6559,351,6910,210,34,244,0,0,0,10952,576,11528
GUJARAT,2010,Educational Standard - Illiterate,1272,128,1400,1987,148,2135,32,18,50,0,0,0,3291,294,3585
GUJARAT,2010,Educational Standard - Below Class X,2201,59,2260,3207,149,3356,141,16,157,0,0,0,5549,224,5773
GUJARAT,2010,Educational Standard - Class X and above but below graduate,548,4,552,1024,46,1070,34,0,34,0,0,0,1606,50,1656
GUJARAT,2010,Educational Standard - Graduate,102,0,102,283,8,291,3,0,3,0,0,0,388,8,396
GUJARAT,2010,Educational Standard - Post-Graduate,20,0,20,38,0,38,0,0,0,0,0,0,58,0,58
GUJARAT,2010,Educational Standard - Holding technical degree/diploma etc,40,0,40,20,0,20,0,0,0,0,0,0,60,0,60
GUJARAT,2011,Educational Standard,4328,176,4504,6368,328,6696,355,46,401,0,0,0,11051,550,11601
GUJARAT,2011,Educational Standard - Illiterate,1301,37,1338,1627,136,1763,58,24,82,0,0,0,2986,197,3183
GUJARAT,2011,Educational Standard - Below Class X,2234,134,2368,3005,126,3131,227,19,246,0,0,0,5466,279,5745
GUJARAT,2011,Educational Standard - Class X and above but below graduate,595,4,599,1306,57,1363,61,3,64,0,0,0,1962,64,2026
GUJARAT,2011,Educational Standard - Graduate,157,0,157,332,9,341,8,0,8,0,0,0,497,9,506
GUJARAT,2011,Educational Standard - Post-Graduate,37,1,38,78,0,78,0,0,0,0,0,0,115,1,116
GUJARAT,2011,Educational Standard - Holding technical degree/diploma etc,4,0,4,20,0,20,1,0,1,0,0,0,25,0,25
GUJARAT,2012,Educational Standard,4269,184,4453,6286,327,6613,468,51,519,0,0,0,11023,562,11585
GUJARAT,2012,Educational Standard - Illiterate,698,77,775,1191,101,1292,136,20,156,0,0,0,2025,198,2223
GUJARAT,2012,Educational Standard - Below Class X,2790,92,2882,3751,189,3940,206,26,232,0,0,0,6747,307,7054
GUJARAT,2012,Educational Standard - Class X and above but below graduate,589,11,600,880,21,901,111,3,114,0,0,0,1580,35,1615
GUJARAT,2012,Educational Standard - Graduate,131,2,133,346,14,360,11,2,13,0,0,0,488,18,506
GUJARAT,2012,Educational Standard - Post-Graduate,33,0,33,72,2,74,4,0,4,0,0,0,109,2,111
GUJARAT,2012,Educational Standard - Holding technical degree/diploma etc,28,2,30,46,0,46,0,0,0,0,0,0,74,2,76
HARYANA,2001,Educational Standard,2984,108,3092,7889,323,8212,0,0,0,44,0,44,10917,431,11348
HARYANA,2001,Educational Standard - Illiterate,1144,66,1210,2316,195,2511,0,0,0,30,0,30,3490,261,3751
HARYANA,2001,Educational Standard - Below Class X,1088,19,1107,3365,99,3464,0,0,0,11,0,11,4464,118,4582
HARYANA,2001,Educational Standard - Class X and above but below graduate,615,12,627,1580,17,1597,0,0,0,3,0,3,2198,29,2227
HARYANA,2001,Educational Standard - Graduate,83,6,89,437,10,447,0,0,0,0,0,0,520,16,536
HARYANA,2001,Educational Standard - Post-Graduate,25,5,30,140,1,141,0,0,0,0,0,0,165,6,171
HARYANA,2001,Educational Standard - Holding technical degree/diploma etc,29,0,29,51,1,52,0,0,0,0,0,0,80,1,81
HARYANA,2002,Educational Standard,3503,130,3633,7396,321,7717,0,0,0,8,0,8,10907,451,11358
HARYANA,2002,Educational Standard - Illiterate,1256,67,1323,2243,127,2370,0,0,0,8,0,8,3507,194,3701
HARYANA,2002,Educational Standard - Below Class X,1412,38,1450,3210,144,3354,0,0,0,0,0,0,4622,182,4804
HARYANA,2002,Educational Standard - Class X and above but below graduate,682,14,696,1617,40,1657,0,0,0,0,0,0,2299,54,2353
HARYANA,2002,Educational Standard - Graduate,119,8,127,258,8,266,0,0,0,0,0,0,377,16,393
HARYANA,2002,Educational Standard - Post-Graduate,15,3,18,32,1,33,0,0,0,0,0,0,47,4,51
HARYANA,2002,Educational Standard - Holding technical degree/diploma etc,19,0,19,36,1,37,0,0,0,0,0,0,55,1,56
HARYANA,2003,Educational Standard,4276,167,4443,7167,337,7504,0,0,0,152,0,152,11595,504,12099
HARYANA,2003,Educational Standard - Illiterate,1432,92,1524,2251,217,2468,0,0,0,101,0,101,3784,309,4093
HARYANA,2003,Educational Standard - Below Class X,1707,54,1761,2994,96,3090,0,0,0,51,0,51,4752,150,4902
HARYANA,2003,Educational Standard - Class X and above but below graduate,921,19,940,1661,23,1684,0,0,0,0,0,0,2582,42,2624
HARYANA,2003,Educational Standard - Graduate,170,0,170,210,1,211,0,0,0,0,0,0,380,1,381
HARYANA,2003,Educational Standard - Post-Graduate,29,2,31,32,0,32,0,0,0,0,0,0,61,2,63
HARYANA,2003,Educational Standard - Holding technical degree/diploma etc,17,0,17,19,0,19,0,0,0,0,0,0,36,0,36
HARYANA,2004,Educational Standard,4411,190,4601,7090,306,7396,0,0,0,13,0,13,11514,496,12010
HARYANA,2004,Educational Standard - Illiterate,1214,96,1310,1912,172,2084,0,0,0,5,0,5,3131,268,3399
HARYANA,2004,Educational Standard - Below Class X,1986,63,2049,3265,95,3360,0,0,0,5,0,5,5256,158,5414
HARYANA,2004,Educational Standard - Class X and above but below graduate,981,28,1009,1594,37,1631,0,0,0,3,0,3,2578,65,2643
HARYANA,2004,Educational Standard - Graduate,157,2,159,215,2,217,0,0,0,0,0,0,372,4,376
HARYANA,2004,Educational Standard - Post-Graduate,28,1,29,47,0,47,0,0,0,0,0,0,75,1,76
HARYANA,2004,Educational Standard - Holding technical degree/diploma etc,45,0,45,57,0,57,0,0,0,0,0,0,102,0,102
HARYANA,2005,Educational Standard,4605,188,4793,7391,326,7717,0,0,0,36,1,37,12032,515,12547
HARYANA,2005,Educational Standard - Illiterate,1532,115,1647,3136,155,3291,0,0,0,17,1,18,4685,271,4956
HARYANA,2005,Educational Standard - Below Class X,1874,58,1932,2846,130,2976,0,0,0,16,0,16,4736,188,4924
HARYANA,2005,Educational Standard - Class X and above but below graduate,836,13,849,1107,32,1139,0,0,0,3,0,3,1946,45,1991
HARYANA,2005,Educational Standard - Graduate,293,1,294,208,9,217,0,0,0,0,0,0,501,10,511
HARYANA,2005,Educational Standard - Post-Graduate,46,0,46,73,0,73,0,0,0,0,0,0,119,0,119
HARYANA,2005,Educational Standard - Holding technical degree/diploma etc,24,1,25,21,0,21,0,0,0,0,0,0,45,1,46
HARYANA,2006,Educational Standard,4788,200,4988,7353,333,7686,0,0,0,13,0,13,12154,533,12687
HARYANA,2006,Educational Standard - Illiterate,1285,144,1429,2429,211,2640,0,0,0,6,0,6,3720,355,4075
HARYANA,2006,Educational Standard - Below Class X,2229,41,2270,3192,83,3275,0,0,0,4,0,4,5425,124,5549
HARYANA,2006,Educational Standard - Class X and above but below graduate,1058,10,1068,1206,30,1236,0,0,0,3,0,3,2267,40,2307
HARYANA,2006,Educational Standard - Graduate,127,3,130,362,6,368,0,0,0,0,0,0,489,9,498
HARYANA,2006,Educational Standard - Post-Graduate,53,2,55,84,3,87,0,0,0,0,0,0,137,5,142
HARYANA,2006,Educational Standard - Holding technical degree/diploma etc,36,0,36,80,0,80,0,0,0,0,0,0,116,0,116
HARYANA,2007,Educational Standard,4775,201,4976,7757,360,8117,0,0,0,0,0,0,12532,561,13093
HARYANA,2007,Educational Standard - Illiterate,1326,147,1473,2098,152,2250,0,0,0,0,0,0,3424,299,3723
HARYANA,2007,Educational Standard - Below Class X,2118,34,2152,2969,100,3069,0,0,0,0,0,0,5087,134,5221
HARYANA,2007,Educational Standard - Class X and above but below graduate,1065,14,1079,2112,95,2207,0,0,0,0,0,0,3177,109,3286
HARYANA,2007,Educational Standard - Graduate,172,3,175,394,11,405,0,0,0,0,0,0,566,14,580
HARYANA,2007,Educational Standard - Post-Graduate,55,3,58,100,2,102,0,0,0,0,0,0,155,5,160
HARYANA,2007,Educational Standard - Holding technical degree/diploma etc,39,0,39,84,0,84,0,0,0,0,0,0,123,0,123
HARYANA,2008,Educational Standard,5132,255,5387,8260,402,8662,0,0,0,0,0,0,13392,657,14049
HARYANA,2008,Educational Standard - Illiterate,1665,153,1818,2063,175,2238,0,0,0,0,0,0,3728,328,4056
HARYANA,2008,Educational Standard - Below Class X,1891,54,1945,3560,123,3683,0,0,0,0,0,0,5451,177,5628
HARYANA,2008,Educational Standard - Class X and above but below graduate,1320,36,1356,1966,85,2051,0,0,0,0,0,0,3286,121,3407
HARYANA,2008,Educational Standard - Graduate,181,7,188,476,14,490,0,0,0,0,0,0,657,21,678
HARYANA,2008,Educational Standard - Post-Graduate,48,5,53,111,5,116,0,0,0,0,0,0,159,10,169
HARYANA,2008,Educational Standard - Holding technical degree/diploma etc,27,0,27,84,0,84,0,0,0,0,0,0,111,0,111
HARYANA,2009,Educational Standard,5528,264,5792,7687,354,8041,0,0,0,4,0,4,13219,618,13837
HARYANA,2009,Educational Standard - Illiterate,1655,86,1741,2155,106,2261,0,0,0,0,0,0,3810,192,4002
HARYANA,2009,Educational Standard - Below Class X,2248,87,2335,2943,149,3092,0,0,0,4,0,4,5195,236,5431
HARYANA,2009,Educational Standard - Class X and above but below graduate,1311,85,1396,2069,72,2141,0,0,0,0,0,0,3380,157,3537
HARYANA,2009,Educational Standard - Graduate,233,4,237,341,20,361,0,0,0,0,0,0,574,24,598
HARYANA,2009,Educational Standard - Post-Graduate,56,2,58,118,6,124,0,0,0,0,0,0,174,8,182
HARYANA,2009,Educational Standard - Holding technical degree/diploma etc,25,0,25,61,1,62,0,0,0,0,0,0,86,1,87
HARYANA,2010,Educational Standard,5966,245,6211,7658,350,8008,0,0,0,0,0,0,13624,595,14219
HARYANA,2010,Educational Standard - Illiterate,1600,92,1692,1914,112,2026,0,0,0,0,0,0,3514,204,3718
HARYANA,2010,Educational Standard - Below Class X,2504,90,2594,3217,120,3337,0,0,0,0,0,0,5721,210,5931
HARYANA,2010,Educational Standard - Class X and above but below graduate,1466,53,1519,1952,97,2049,0,0,0,0,0,0,3418,150,3568
HARYANA,2010,Educational Standard - Graduate,282,8,290,398,19,417,0,0,0,0,0,0,680,27,707
HARYANA,2010,Educational Standard - Post-Graduate,75,2,77,109,2,111,0,0,0,0,0,0,184,4,188
HARYANA,2010,Educational Standard - Holding technical degree/diploma etc,39,0,39,68,0,68,0,0,0,0,0,0,107,0,107
HARYANA,2011,Educational Standard,6244,285,6529,8118,385,8503,0,0,0,1,0,1,14363,670,15033
HARYANA,2011,Educational Standard - Illiterate,1713,158,1871,2152,192,2344,0,0,0,0,0,0,3865,350,4215
HARYANA,2011,Educational Standard - Below Class X,2597,47,2644,3192,125,3317,0,0,0,1,0,1,5790,172,5962
HARYANA,2011,Educational Standard - Class X and above but below graduate,1533,66,1599,2145,51,2196,0,0,0,0,0,0,3678,117,3795
HARYANA,2011,Educational Standard - Graduate,294,10,304,449,12,461,0,0,0,0,0,0,743,22,765
HARYANA,2011,Educational Standard - Post-Graduate,70,4,74,105,4,109,0,0,0,0,0,0,175,8,183
HARYANA,2011,Educational Standard - Holding technical degree/diploma etc,37,0,37,75,1,76,0,0,0,0,0,0,112,1,113
HARYANA,2012,Educational Standard,6411,290,6701,9791,460,10251,0,0,0,0,0,0,16202,750,16952
HARYANA,2012,Educational Standard - Illiterate,1561,140,1701,2332,189,2521,0,0,0,0,0,0,3893,329,4222
HARYANA,2012,Educational Standard - Below Class X,2637,98,2735,4169,154,4323,0,0,0,0,0,0,6806,252,7058
HARYANA,2012,Educational Standard - Class X and above but below graduate,1775,36,1811,2512,88,2600,0,0,0,0,0,0,4287,124,4411
HARYANA,2012,Educational Standard - Graduate,324,10,334,498,24,522,0,0,0,0,0,0,822,34,856
HARYANA,2012,Educational Standard - Post-Graduate,68,3,71,108,2,110,0,0,0,0,0,0,176,5,181
HARYANA,2012,Educational Standard - Holding technical degree/diploma etc,46,3,49,172,3,175,0,0,0,0,0,0,218,6,224
HIMACHAL PRADESH,2001,Educational Standard,384,11,395,497,15,512,0,0,0,0,0,0,881,26,907
HIMACHAL PRADESH,2001,Educational Standard - Illiterate,184,7,191,198,9,207,0,0,0,0,0,0,382,16,398
HIMACHAL PRADESH,2001,Educational Standard - Below Class X,80,2,82,120,4,124,0,0,0,0,0,0,200,6,206
HIMACHAL PRADESH,2001,Educational Standard - Class X and above but below graduate,68,1,69,125,1,126,0,0,0,0,0,0,193,2,195
HIMACHAL PRADESH,2001,Educational Standard - Graduate,46,1,47,50,1,51,0,0,0,0,0,0,96,2,98
HIMACHAL PRADESH,2001,Educational Standard - Post-Graduate,6,0,6,4,0,4,0,0,0,0,0,0,10,0,10
HIMACHAL PRADESH,2001,Educational Standard - Holding technical degree/diploma etc,0,0,0,0,0,0,0,0,0,0,0,0,0,0,0
HIMACHAL PRADESH,2002,Educational Standard,412,7,419,458,20,478,0,0,0,0,0,0,870,27,897
HIMACHAL PRADESH,2002,Educational Standard - Illiterate,86,4,90,94,9,103,0,0,0,0,0,0,180,13,193
HIMACHAL PRADESH,2002,Educational Standard - Below Class X,244,3,247,194,8,202,0,0,0,0,0,0,438,11,449
HIMACHAL PRADESH,2002,Educational Standard - Class X and above but below graduate,67,0,67,149,1,150,0,0,0,0,0,0,216,1,217
HIMACHAL PRADESH,2002,Educational Standard - Graduate,9,0,9,19,2,21,0,0,0,0,0,0,28,2,30
HIMACHAL PRADESH,2002,Educational Standard - Post-Graduate,5,0,5,1,0,1,0,0,0,0,0,0,6,0,6
HIMACHAL PRADESH,2002,Educational Standard - Holding technical degree/diploma etc,1,0,1,1,0,1,0,0,0,0,0,0,2,0,2
HIMACHAL PRADESH,2003,Educational Standard,464,12,476,483,19,502,0,0,0,0,0,0,947,31,978
HIMACHAL PRADESH,2003,Educational Standard - Illiterate,40,3,43,84,6,90,0,0,0,0,0,0,124,9,133
HIMACHAL PRADESH,2003,Educational Standard - Below Class X,340,8,348,298,9,307,0,0,0,0,0,0,638,17,655
HIMACHAL PRADESH,2003,Educational Standard - Class X and above but below graduate,68,1,69,87,4,91,0,0,0,0,0,0,155,5,160
HIMACHAL PRADESH,2003,Educational Standard - Graduate,8,0,8,11,0,11,0,0,0,0,0,0,19,0,19
HIMACHAL PRADESH,2003,Educational Standard - Post-Graduate,3,0,3,0,0,0,0,0,0,0,0,0,3,0,3
HIMACHAL PRADESH,2003,Educational Standard - Holding technical degree/diploma etc,5,0,5,3,0,3,0,0,0,0,0,0,8,0,8
HIMACHAL PRADESH,2004,Educational Standard,540,17,557,468,19,487,0,0,0,0,0,0,1008,36,1044
HIMACHAL PRADESH,2004,Educational Standard - Illiterate,43,2,45,80,10,90,0,0,0,0,0,0,123,12,135
HIMACHAL PRADESH,2004,Educational Standard - Below Class X,258,11,269,250,7,257,0,0,0,0,0,0,508,18,526
HIMACHAL PRADESH,2004,Educational Standard - Class X and above but below graduate,227,4,231,121,2,123,0,0,0,0,0,0,348,6,354
HIMACHAL PRADESH,2004,Educational Standard - Graduate,7,0,7,16,0,16,0,0,0,0,0,0,23,0,23
HIMACHAL PRADESH,2004,Educational Standard - Post-Graduate,5,0,5,0,0,0,0,0,0,0,0,0,5,0,5
HIMACHAL PRADESH,2004,Educational Standard - Holding technical degree/diploma etc,0,0,0,1,0,1,0,0,0,0,0,0,1,0,1
HIMACHAL PRADESH,2005,Educational Standard,614,18,632,520,16,536,0,0,0,0,0,0,1134,34,1168
HIMACHAL PRADESH,2005,Educational Standard - Illiterate,108,7,115,148,9,157,0,0,0,0,0,0,256,16,272
HIMACHAL PRADESH,2005,Educational Standard - Below Class X,316,7,323,221,2,223,0,0,0,0,0,0,537,9,546
HIMACHAL PRADESH,2005,Educational Standard - Class X and above but below graduate,156,4,160,119,5,124,0,0,0,0,0,0,275,9,284
HIMACHAL PRADESH,2005,Educational Standard - Graduate,26,0,26,32,0,32,0,0,0,0,0,0,58,0,58
HIMACHAL PRADESH,2005,Educational Standard - Post-Graduate,8,0,8,0,0,0,0,0,0,0,0,0,8,0,8
HIMACHAL PRADESH,2005,Educational Standard - Holding technical degree/diploma etc,0,0,0,0,0,0,0,0,0,0,0,0,0,0,0
HIMACHAL PRADESH,2006,Educational Standard,740,24,764,551,21,572,0,0,0,0,0,0,1291,45,1336
HIMACHAL PRADESH,2006,Educational Standard - Illiterate,92,9,101,144,14,158,0,0,0,0,0,0,236,23,259
HIMACHAL PRADESH,2006,Educational Standard - Below Class X,332,15,347,209,5,214,0,0,0,0,0,0,541,20,561
HIMACHAL PRADESH,2006,Educational Standard - Class X and above but below graduate,290,0,290,178,2,180,0,0,0,0,0,0,468,2,470
HIMACHAL PRADESH,2006,Educational Standard - Graduate,20,0,20,13,0,13,0,0,0,0,0,0,33,0,33
HIMACHAL PRADESH,2006,Educational Standard - Post-Graduate,6,0,6,5,0,5,0,0,0,0,0,0,11,0,11
HIMACHAL PRADESH,2006,Educational Standard - Holding technical degree/diploma etc,0,0,0,2,0,2,0,0,0,0,0,0,2,0,2
HIMACHAL PRADESH,2007,Educational Standard,838,37,875,536,24,560,0,0,0,0,0,0,1374,61,1435
HIMACHAL PRADESH,2007,Educational Standard - Illiterate,80,18,98,85,11,96,0,0,0,0,0,0,165,29,194
HIMACHAL PRADESH,2007,Educational Standard - Below Class X,420,7,427,239,9,248,0,0,0,0,0,0,659,16,675
HIMACHAL PRADESH,2007,Educational Standard - Class X and above but below graduate,313,12,325,205,4,209,0,0,0,0,0,0,518,16,534
HIMACHAL PRADESH,2007,Educational Standard - Graduate,22,0,22,7,0,7,0,0,0,0,0,0,29,0,29
HIMACHAL PRADESH,2007,Educational Standard - Post-Graduate,3,0,3,0,0,0,0,0,0,0,0,0,3,0,3
HIMACHAL PRADESH,2007,Educational Standard - Holding technical degree/diploma etc,0,0,0,0,0,0,0,0,0,0,0,0,0,0,0
HIMACHAL PRADESH,2008,Educational Standard,858,32,890,552,26,578,0,0,0,0,0,0,1410,58,1468
HIMACHAL PRADESH,2008,Educational Standard - Illiterate,207,19,226,136,10,146,0,0,0,0,0,0,343,29,372
HIMACHAL PRADESH,2008,Educational Standard - Below Class X,205,11,216,215,7,222,0,0,0,0,0,0,420,18,438
HIMACHAL PRADESH,2008,Educational Standard - Class X and above but below graduate,392,2,394,164,5,169,0,0,0,0,0,0,556,7,563
HIMACHAL PRADESH,2008,Educational Standard - Graduate,42,0,42,28,4,32,0,0,0,0,0,0,70,4,74
HIMACHAL PRADESH,2008,Educational Standard - Post-Graduate,7,0,7,4,0,4,0,0,0,0,0,0,11,0,11
HIMACHAL PRADESH,2008,Educational Standard - Holding technical degree/diploma etc,5,0,5,5,0,5,0,0,0,0,0,0,10,0,10
HIMACHAL PRADESH,2009,Educational Standard,807,35,842,695,17,712,0,0,0,0,0,0,1502,52,1554
HIMACHAL PRADESH,2009,Educational Standard - Illiterate,172,20,192,128,7,135,0,0,0,0,0,0,300,27,327
HIMACHAL PRADESH,2009,Educational Standard - Below Class X,384,11,395,348,7,355,0,0,0,0,0,0,732,18,750
HIMACHAL PRADESH,2009,Educational Standard - Class X and above but below graduate,218,3,221,204,3,207,0,0,0,0,0,0,422,6,428
HIMACHAL PRADESH,2009,Educational Standard - Graduate,27,1,28,14,0,14,0,0,0,0,0,0,41,1,42
HIMACHAL PRADESH,2009,Educational Standard - Post-Graduate,4,0,4,0,0,0,0,0,0,0,0,0,4,0,4
HIMACHAL PRADESH,2009,Educational Standard - Holding technical degree/diploma etc,2,0,2,1,0,1,0,0,0,0,0,0,3,0,3
HIMACHAL PRADESH,2010,Educational Standard,935,27,962,600,23,623,0,0,0,0,0,0,1535,50,1585
HIMACHAL PRADESH,2010,Educational Standard - Illiterate,181,27,208,84,11,95,0,0,0,0,0,0,265,38,303
HIMACHAL PRADESH,2010,Educational Standard - Below Class X,452,0,452,236,9,245,0,0,0,0,0,0,688,9,697
HIMACHAL PRADESH,2010,Educational Standard - Class X and above but below graduate,262,0,262,260,3,263,0,0,0,0,0,0,522,3,525
HIMACHAL PRADESH,2010,Educational Standard - Graduate,33,0,33,17,0,17,0,0,0,0,0,0,50,0,50
HIMACHAL PRADESH,2010,Educational Standard - Post-Graduate,5,0,5,2,0,2,0,0,0,0,0,0,7,0,7
HIMACHAL PRADESH,2010,Educational Standard - Holding technical degree/diploma etc,2,0,2,1,0,1,0,0,0,0,0,0,3,0,3
HIMACHAL PRADESH,2011,Educational Standard,913,29,942,632,33,665,0,0,0,0,0,0,1545,62,1607
HIMACHAL PRADESH,2011,Educational Standard - Illiterate,187,20,207,74,11,85,0,0,0,0,0,0,261,31,292
HIMACHAL PRADESH,2011,Educational Standard - Below Class X,430,3,433,343,12,355,0,0,0,0,0,0,773,15,788
HIMACHAL PRADESH,2011,Educational Standard - Class X and above but below graduate,261,5,266,177,9,186,0,0,0,0,0,0,438,14,452
HIMACHAL PRADESH,2011,Educational Standard - Graduate,24,1,25,32,0,32,0,0,0,0,0,0,56,1,57
HIMACHAL PRADESH,2011,Educational Standard - Post-Graduate,8,0,8,2,0,2,0,0,0,0,0,0,10,0,10
HIMACHAL PRADESH,2011,Educational Standard - Holding technical degree/diploma etc,3,0,3,4,1,5,0,0,0,0,0,0,7,1,8
HIMACHAL PRADESH,2012,Educational Standard,916,36,952,727,37,764,0,0,0,0,0,0,1643,73,1716
HIMACHAL PRADESH,2012,Educational Standard - Illiterate,197,19,216,122,18,140,0,0,0,0,0,0,319,37,356
HIMACHAL PRADESH,2012,Educational Standard - Below Class X,410,6,416,315,10,325,0,0,0,0,0,0,725,16,741
HIMACHAL PRADESH,2012,Educational Standard - Class X and above but below graduate,269,10,279,253,8,261,0,0,0,0,0,0,522,18,540
HIMACHAL PRADESH,2012,Educational Standard - Graduate,31,1,32,22,1,23,0,0,0,0,0,0,53,2,55
HIMACHAL PRADESH,2012,Educational Standard - Post-Graduate,4,0,4,1,0,1,0,0,0,0,0,0,5,0,5
HIMACHAL PRADESH,2012,Educational Standard - Holding technical degree/diploma etc,5,0,5,14,0,14,0,0,0,0,0,0,19,0,19
JAMMU & KASHMIR,2001,Educational Standard,118,5,123,1072,33,1105,414,2,416,3,0,3,1607,40,1647
JAMMU & KASHMIR,2001,Educational Standard - Illiterate,32,5,37,334,18,352,70,2,72,3,0,3,439,25,464
JAMMU & KASHMIR,2001,Educational Standard - Below Class X,75,0,75,467,11,478,178,0,178,0,0,0,720,11,731
JAMMU & KASHMIR,2001,Educational Standard - Class X and above but below graduate,9,0,9,257,3,260,146,0,146,0,0,0,412,3,415
JAMMU & KASHMIR,2001,Educational Standard - Graduate,2,0,2,13,1,14,20,0,20,0,0,0,35,1,36
JAMMU & KASHMIR,2001,Educational Standard - Post-Graduate,0,0,0,0,0,0,0,0,0,0,0,0,0,0,0
JAMMU & KASHMIR,2001,Educational Standard - Holding technical degree/diploma etc,0,0,0,1,0,1,0,0,0,0,0,0,1,0,1
JAMMU & KASHMIR,2002,Educational Standard,126,3,129,1183,46,1229,443,1,444,1,0,1,1753,50,1803
JAMMU & KASHMIR,2002,Educational Standard - Illiterate,37,3,40,373,28,401,117,1,118,1,0,1,528,32,560
JAMMU & KASHMIR,2002,Educational Standard - Below Class X,67,0,67,486,13,499,215,0,215,0,0,0,768,13,781
JAMMU & KASHMIR,2002,Educational Standard - Class X and above but below graduate,16,0,16,276,3,279,80,0,80,0,0,0,372,3,375
JAMMU & KASHMIR,2002,Educational Standard - Graduate,3,0,3,33,2,35,5,0,5,0,0,0,41,2,43
JAMMU & KASHMIR,2002,Educational Standard - Post-Graduate,0,0,0,0,0,0,0,0,0,0,0,0,0,0,0
JAMMU & KASHMIR,2002,Educational Standard - Holding technical degree/diploma etc,3,0,3,15,0,15,26,0,26,0,0,0,44,0,44
JAMMU & KASHMIR,2003,Educational Standard,167,1,168,1266,64,1330,397,0,397,0,0,0,1830,65,1895
JAMMU & KASHMIR,2003,Educational Standard - Illiterate,22,1,23,168,29,197,6,0,6,0,0,0,196,30,226
JAMMU & KASHMIR,2003,Educational Standard - Below Class X,87,0,87,844,26,870,83,0,83,0,0,0,1014,26,1040
JAMMU & KASHMIR,2003,Educational Standard - Class X and above but below graduate,53,0,53,163,7,170,297,0,297,0,0,0,513,7,520
JAMMU & KASHMIR,2003,Educational Standard - Graduate,5,0,5,86,2,88,9,0,9,0,0,0,100,2,102
JAMMU & KASHMIR,2003,Educational Standard - Post-Graduate,0,0,0,5,0,5,2,0,2,0,0,0,7,0,7
JAMMU & KASHMIR,2003,Educational Standard - Holding technical degree/diploma etc,0,0,0,0,0,0,0,0,0,0,0,0,0,0,0
JAMMU & KASHMIR,2004,Educational Standard,195,5,200,1334,53,1387,449,2,451,1,0,1,1979,60,2039
JAMMU & KASHMIR,2004,Educational Standard - Illiterate,66,4,70,383,44,427,135,1,136,1,0,1,585,49,634
JAMMU & KASHMIR,2004,Educational Standard - Below Class X,51,1,52,579,7,586,148,0,148,0,0,0,778,8,786
JAMMU & KASHMIR,2004,Educational Standard - Class X and above but below graduate,72,0,72,341,2,343,153,1,154,0,0,0,566,3,569
JAMMU & KASHMIR,2004,Educational Standard - Graduate,5,0,5,24,0,24,9,0,9,0,0,0,38,0,38
JAMMU & KASHMIR,2004,Educational Standard - Post-Graduate,1,0,1,4,0,4,2,0,2,0,0,0,7,0,7
JAMMU & KASHMIR,2004,Educational Standard - Holding technical degree/diploma etc,0,0,0,3,0,3,2,0,2,0,0,0,5,0,5
JAMMU & KASHMIR,2005,Educational Standard,211,10,221,1482,57,1539,373,4,377,0,0,0,2066,71,2137
JAMMU & KASHMIR,2005,Educational Standard - Illiterate,80,5,85,438,42,480,123,4,127,0,0,0,641,51,692
JAMMU & KASHMIR,2005,Educational Standard - Below Class X,90,5,95,607,11,618,75,0,75,0,0,0,772,16,788
JAMMU & KASHMIR,2005,Educational Standard - Class X and above but below graduate,37,0,37,395,4,399,154,0,154,0,0,0,586,4,590
JAMMU & KASHMIR,2005,Educational Standard - Graduate,3,0,3,32,0,32,18,0,18,0,0,0,53,0,53
JAMMU & KASHMIR,2005,Educational Standard - Post-Graduate,0,0,0,10,0,10,2,0,2,0,0,0,12,0,12
JAMMU & KASHMIR,2005,Educational Standard - Holding technical degree/diploma etc,1,0,1,0,0,0,1,0,1,0,0,0,2,0,2
JAMMU & KASHMIR,2006,Educational Standard,255,9,264,1585,49,1634,368,1,369,3,0,3,2211,59,2270
JAMMU & KASHMIR,2006,Educational Standard - Illiterate,108,7,115,477,40,517,132,0,132,3,0,3,720,47,767
JAMMU & KASHMIR,2006,Educational Standard - Below Class X,96,2,98,660,7,667,126,0,126,0,0,0,882,9,891
JAMMU & KASHMIR,2006,Educational Standard - Class X and above but below graduate,47,0,47,393,2,395,97,1,98,0,0,0,537,3,540
JAMMU & KASHMIR,2006,Educational Standard - Graduate,3,0,3,45,0,45,6,0,6,0,0,0,54,0,54
JAMMU & KASHMIR,2006,Educational Standard - Post-Graduate,0,0,0,4,0,4,3,0,3,0,0,0,7,0,7
JAMMU & KASHMIR,2006,Educational Standard - Holding technical degree/diploma etc,1,0,1,6,0,6,4,0,4,0,0,0,11,0,11
JAMMU & KASHMIR,2007,Educational Standard,285,7,292,1660,72,1732,272,3,275,0,0,0,2217,82,2299
JAMMU & KASHMIR,2007,Educational Standard - Illiterate,120,5,125,562,51,613,65,0,65,0,0,0,747,56,803
JAMMU & KASHMIR,2007,Educational Standard - Below Class X,82,2,84,581,15,596,63,0,63,0,0,0,726,17,743
JAMMU & KASHMIR,2007,Educational Standard - Class X and above but below graduate,75,0,75,434,6,440,106,3,109,0,0,0,615,9,624
JAMMU & KASHMIR,2007,Educational Standard - Graduate,5,0,5,73,0,73,36,0,36,0,0,0,114,0,114
JAMMU & KASHMIR,2007,Educational Standard - Post-Graduate,2,0,2,5,0,5,1,0,1,0,0,0,8,0,8
JAMMU & KASHMIR,2007,Educational Standard - Holding technical degree/diploma etc,1,0,1,5,0,5,1,0,1,0,0,0,7,0,7
JAMMU & KASHMIR,2008,Educational Standard,329,9,338,1631,75,1706,265,1,266,0,0,0,2225,85,2310
JAMMU & KASHMIR,2008,Educational Standard - Illiterate,143,9,152,583,54,637,49,1,50,0,0,0,775,64,839
JAMMU & KASHMIR,2008,Educational Standard - Below Class X,140,0,140,640,16,656,127,0,127,0,0,0,907,16,923
JAMMU & KASHMIR,2008,Educational Standard - Class X and above but below graduate,41,0,41,346,4,350,80,0,80,0,0,0,467,4,471
JAMMU & KASHMIR,2008,Educational Standard - Graduate,2,0,2,51,1,52,8,0,8,0,0,0,61,1,62
JAMMU & KASHMIR,2008,Educational Standard - Post-Graduate,1,0,1,9,0,9,1,0,1,0,0,0,11,0,11
JAMMU & KASHMIR,2008,Educational Standard - Holding technical degree/diploma etc,2,0,2,2,0,2,0,0,0,0,0,0,4,0,4
JAMMU & KASHMIR,2009,Educational Standard,346,12,358,1736,85,1821,181,1,182,1,0,1,2264,98,2362
JAMMU & KASHMIR,2009,Educational Standard - Illiterate,126,11,137,443,36,479,50,0,50,0,0,0,619,47,666
JAMMU & KASHMIR,2009,Educational Standard - Below Class X,132,1,133,820,39,859,79,1,80,1,0,1,1032,41,1073
JAMMU & KASHMIR,2009,Educational Standard - Class X and above but below graduate,81,0,81,399,10,409,47,0,47,0,0,0,527,10,537
JAMMU & KASHMIR,2009,Educational Standard - Graduate,7,0,7,70,0,70,5,0,5,0,0,0,82,0,82
JAMMU & KASHMIR,2009,Educational Standard - Post-Graduate,0,0,0,2,0,2,0,0,0,0,0,0,2,0,2
JAMMU & KASHMIR,2009,Educational Standard - Holding technical degree/diploma etc,0,0,0,2,0,2,0,0,0,0,0,0,2,0,2
JAMMU & KASHMIR,2010,Educational Standard,252,7,259,1823,84,1907,394,15,409,2,0,2,2471,106,2577
JAMMU & KASHMIR,2010,Educational Standard - Illiterate,85,4,89,703,55,758,128,11,139,0,0,0,916,70,986
JAMMU & KASHMIR,2010,Educational Standard - Below Class X,113,3,116,633,25,658,103,3,106,2,0,2,851,31,882
JAMMU & KASHMIR,2010,Educational Standard - Class X and above but below graduate,44,0,44,408,3,411,129,1,130,0,0,0,581,4,585
JAMMU & KASHMIR,2010,Educational Standard - Graduate,7,0,7,69,1,70,29,0,29,0,0,0,105,1,106
JAMMU & KASHMIR,2010,Educational Standard - Post-Graduate,2,0,2,6,0,6,5,0,5,0,0,0,13,0,13
JAMMU & KASHMIR,2010,Educational Standard - Holding technical degree/diploma etc,1,0,1,4,0,4,0,0,0,0,0,0,5,0,5
JAMMU & KASHMIR,2011,Educational Standard,291,10,301,2025,88,2113,234,5,239,10,0,10,2560,103,2663
JAMMU & KASHMIR,2011,Educational Standard - Illiterate,158,2,160,502,36,538,66,5,71,10,0,10,736,43,779
JAMMU & KASHMIR,2011,Educational Standard - Below Class X,76,8,84,791,27,818,91,0,91,0,0,0,958,35,993
JAMMU & KASHMIR,2011,Educational Standard - Class X and above but below graduate,41,0,41,630,24,654,74,0,74,0,0,0,745,24,769
JAMMU & KASHMIR,2011,Educational Standard - Graduate,12,0,12,81,1,82,1,0,1,0,0,0,94,1,95
JAMMU & KASHMIR,2011,Educational Standard - Post-Graduate,2,0,2,19,0,19,2,0,2,0,0,0,23,0,23
JAMMU & KASHMIR,2011,Educational Standard - Holding technical degree/diploma etc,2,0,2,2,0,2,0,0,0,0,0,0,4,0,4
JAMMU & KASHMIR,2012,Educational Standard,376,13,389,1927,80,2007,144,0,144,0,0,0,2447,93,2540
JAMMU & KASHMIR,2012,Educational Standard - Illiterate,107,5,112,610,38,648,62,0,62,0,0,0,779,43,822
JAMMU & KASHMIR,2012,Educational Standard - Below Class X,175,5,180,742,35,777,54,0,54,0,0,0,971,40,1011
JAMMU & KASHMIR,2012,Educational Standard - Class X and above but below graduate,81,3,84,509,6,515,25,0,25,0,0,0,615,9,624
JAMMU & KASHMIR,2012,Educational Standard - Graduate,8,0,8,54,1,55,2,0,2,0,0,0,64,1,65
JAMMU & KASHMIR,2012,Educational Standard - Post-Graduate,3,0,3,9,0,9,1,0,1,0,0,0,13,0,13
JAMMU & KASHMIR,2012,Educational Standard - Holding technical degree/diploma etc,2,0,2,3,0,3,0,0,0,0,0,0,5,0,5
JHARKHAND,2001,Educational Standard,2371,49,2420,13686,392,14078,9,0,9,10,0,10,16076,441,16517
JHARKHAND,2001,Educational Standard - Illiterate,993,32,1025,5497,254,5751,0,0,0,0,0,0,6490,286,6776
JHARKHAND,2001,Educational Standard - Below Class X,718,10,728,4648,120,4768,7,0,7,5,0,5,5378,130,5508
JHARKHAND,2001,Educational Standard - Class X and above but below graduate,385,6,391,2464,12,2476,2,0,2,3,0,3,2854,18,2872
JHARKHAND,2001,Educational Standard - Graduate,145,1,146,877,6,883,0,0,0,2,0,2,1024,7,1031
JHARKHAND,2001,Educational Standard - Post-Graduate,81,0,81,123,0,123,0,0,0,0,0,0,204,0,204
JHARKHAND,2001,Educational Standard - Holding technical degree/diploma etc,49,0,49,77,0,77,0,0,0,0,0,0,126,0,126
JHARKHAND,2002,Educational Standard,2942,71,3013,11689,405,12094,18,0,18,3,0,3,14652,476,15128
JHARKHAND,2002,Educational Standard - Illiterate,1267,41,1308,4702,283,4985,0,0,0,1,0,1,5970,324,6294
JHARKHAND,2002,Educational Standard - Below Class X,860,20,880,4002,97,4099,3,0,3,0,0,0,4865,117,4982
JHARKHAND,2002,Educational Standard - Class X and above but below graduate,402,8,410,2177,23,2200,11,0,11,2,0,2,2592,31,2623
JHARKHAND,2002,Educational Standard - Graduate,249,2,251,470,2,472,4,0,4,0,0,0,723,4,727
JHARKHAND,2002,Educational Standard - Post-Graduate,106,0,106,153,0,153,0,0,0,0,0,0,259,0,259
JHARKHAND,2002,Educational Standard - Holding technical degree/diploma etc,58,0,58,185,0,185,0,0,0,0,0,0,243,0,243
JHARKHAND,2003,Educational Standard,4130,127,4257,11720,414,12134,13,0,13,11,0,11,15874,541,16415
JHARKHAND,2003,Educational Standard - Illiterate,1590,87,1677,4506,280,4786,2,0,2,5,0,5,6103,367,6470
JHARKHAND,2003,Educational Standard - Below Class X,1416,29,1445,3990,115,4105,1,0,1,3,0,3,5410,144,5554
JHARKHAND,2003,Educational Standard - Class X and above but below graduate,693,9,702,2551,16,2567,10,0,10,2,0,2,3256,25,3281
JHARKHAND,2003,Educational Standard - Graduate,255,2,257,453,3,456,0,0,0,1,0,1,709,5,714
JHARKHAND,2003,Educational Standard - Post-Graduate,120,0,120,70,0,70,0,0,0,0,0,0,190,0,190
JHARKHAND,2003,Educational Standard - Holding technical degree/diploma etc,56,0,56,150,0,150,0,0,0,0,0,0,206,0,206
JHARKHAND,2004,Educational Standard,4902,138,5040,11954,493,12447,10,0,10,0,0,0,16866,631,17497
JHARKHAND,2004,Educational Standard - Illiterate,2014,92,2106,4204,337,4541,0,0,0,0,0,0,6218,429,6647
JHARKHAND,2004,Educational Standard - Below Class X,1505,36,1541,4878,133,5011,0,0,0,0,0,0,6383,169,6552
JHARKHAND,2004,Educational Standard - Class X and above but below graduate,859,10,869,1908,18,1926,10,0,10,0,0,0,2777,28,2805
JHARKHAND,2004,Educational Standard - Graduate,390,0,390,660,5,665,0,0,0,0,0,0,1050,5,1055
JHARKHAND,2004,Educational Standard - Post-Graduate,85,0,85,140,0,140,0,0,0,0,0,0,225,0,225
JHARKHAND,2004,Educational Standard - Holding technical degree/diploma etc,49,0,49,164,0,164,0,0,0,0,0,0,213,0,213
JHARKHAND,2005,Educational Standard,5142,152,5294,13393,546,13939,0,0,0,0,0,0,18535,698,19233
JHARKHAND,2005,Educational Standard - Illiterate,1633,81,1714,4737,314,5051,0,0,0,0,0,0,6370,395,6765
JHARKHAND,2005,Educational Standard - Below Class X,1991,62,2053,5265,189,5454,0,0,0,0,0,0,7256,251,7507
JHARKHAND,2005,Educational Standard - Class X and above but below graduate,985,9,994,2459,38,2497,0,0,0,0,0,0,3444,47,3491
JHARKHAND,2005,Educational Standard - Graduate,383,0,383,569,5,574,0,0,0,0,0,0,952,5,957
JHARKHAND,2005,Educational Standard - Post-Graduate,88,0,88,178,0,178,0,0,0,0,0,0,266,0,266
JHARKHAND,2005,Educational Standard - Holding technical degree/diploma etc,62,0,62,185,0,185,0,0,0,0,0,0,247,0,247
JHARKHAND,2006,Educational Standard,7123,246,7369,12806,533,13339,1,0,1,0,0,0,19930,779,20709
JHARKHAND,2006,Educational Standard - Illiterate,2991,171,3162,5668,357,6025,0,0,0,0,0,0,8659,528,9187
JHARKHAND,2006,Educational Standard - Below Class X,2230,64,2294,4342,136,4478,0,0,0,0,0,0,6572,200,6772
JHARKHAND,2006,Educational Standard - Class X and above but below graduate,1232,11,1243,2320,38,2358,1,0,1,0,0,0,3553,49,3602
JHARKHAND,2006,Educational Standard - Graduate,503,0,503,351,2,353,0,0,0,0,0,0,854,2,856
JHARKHAND,2006,Educational Standard - Post-Graduate,128,0,128,98,0,98,0,0,0,0,0,0,226,0,226
JHARKHAND,2006,Educational Standard - Holding technical degree/diploma etc,39,0,39,27,0,27,0,0,0,0,0,0,66,0,66
JHARKHAND,2007,Educational Standard,5681,184,5865,11590,473,12063,6,0,6,2,0,2,17279,657,17936
JHARKHAND,2007,Educational Standard - Illiterate,1821,85,1906,4305,289,4594,0,0,0,2,0,2,6128,374,6502
JHARKHAND,2007,Educational Standard - Below Class X,1585,74,1659,4443,153,4596,3,0,3,0,0,0,6031,227,6258
JHARKHAND,2007,Educational Standard - Class X and above but below graduate,1532,24,1556,2377,31,2408,2,0,2,0,0,0,3911,55,3966
JHARKHAND,2007,Educational Standard - Graduate,527,1,528,369,0,369,1,0,1,0,0,0,897,1,898
JHARKHAND,2007,Educational Standard - Post-Graduate,83,0,83,65,0,65,0,0,0,0,0,0,148,0,148
JHARKHAND,2007,Educational Standard - Holding technical degree/diploma etc,133,0,133,31,0,31,0,0,0,0,0,0,164,0,164
JHARKHAND,2008,Educational Standard,5614,170,5784,12128,482,12610,6,0,6,3,0,3,17751,652,18403
JHARKHAND,2008,Educational Standard - Illiterate,888,82,970,2712,230,2942,0,0,0,0,0,0,3600,312,3912
JHARKHAND,2008,Educational Standard - Below Class X,3517,83,3600,6786,219,7005,4,0,4,1,0,1,10308,302,10610
JHARKHAND,2008,Educational Standard - Class X and above but below graduate,834,2,836,2078,28,2106,1,0,1,1,0,1,2914,30,2944
JHARKHAND,2008,Educational Standard - Graduate,286,3,289,449,3,452,1,0,1,1,0,1,737,6,743
JHARKHAND,2008,Educational Standard - Post-Graduate,80,0,80,95,2,97,0,0,0,0,0,0,175,2,177
JHARKHAND,2008,Educational Standard - Holding technical degree/diploma etc,9,0,9,8,0,8,0,0,0,0,0,0,17,0,17
JHARKHAND,2009,Educational Standard,5342,167,5509,11198,484,11682,5,0,5,0,0,0,16545,651,17196
JHARKHAND,2009,Educational Standard - Illiterate,600,35,635,2075,201,2276,0,0,0,0,0,0,2675,236,2911
JHARKHAND,2009,Educational Standard - Below Class X,3541,126,3667,6276,226,6502,5,0,5,0,0,0,9822,352,10174
JHARKHAND,2009,Educational Standard - Class X and above but below graduate,884,6,890,2301,48,2349,0,0,0,0,0,0,3185,54,3239
JHARKHAND,2009,Educational Standard - Graduate,237,0,237,433,4,437,0,0,0,0,0,0,670,4,674
JHARKHAND,2009,Educational Standard - Post-Graduate,65,0,65,78,4,82,0,0,0,0,0,0,143,4,147
JHARKHAND,2009,Educational Standard - Holding technical degree/diploma etc,15,0,15,35,1,36,0,0,0,0,0,0,50,1,51
JHARKHAND,2010,Educational Standard,5093,168,5261,12226,539,12765,16,0,16,0,0,0,17335,707,18042
JHARKHAND,2010,Educational Standard - Illiterate,731,68,799,2824,254,3078,0,0,0,0,0,0,3555,322,3877
JHARKHAND,2010,Educational Standard - Below Class X,3172,82,3254,5961,205,6166,8,0,8,0,0,0,9141,287,9428
JHARKHAND,2010,Educational Standard - Class X and above but below graduate,830,16,846,2702,71,2773,8,0,8,0,0,0,3540,87,3627
JHARKHAND,2010,Educational Standard - Graduate,275,2,277,546,6,552,0,0,0,0,0,0,821,8,829
JHARKHAND,2010,Educational Standard - Post-Graduate,56,0,56,102,3,105,0,0,0,0,0,0,158,3,161
JHARKHAND,2010,Educational Standard - Holding technical degree/diploma etc,29,0,29,91,0,91,0,0,0,0,0,0,120,0,120
JHARKHAND,2011,Educational Standard,4354,139,4493,11495,578,12073,17,1,18,2,0,2,15868,718,16586
JHARKHAND,2011,Educational Standard - Illiterate,647,52,699,2876,308,3184,2,0,2,0,0,0,3525,360,3885
JHARKHAND,2011,Educational Standard - Below Class X,2452,71,2523,5764,198,5962,8,0,8,1,0,1,8225,269,8494
JHARKHAND,2011,Educational Standard - Class X and above but below graduate,875,14,889,2225,61,2286,6,0,6,1,0,1,3107,75,3182
JHARKHAND,2011,Educational Standard - Graduate,280,2,282,500,7,507,0,0,0,0,0,0,780,9,789
JHARKHAND,2011,Educational Standard - Post-Graduate,66,0,66,66,4,70,1,1,2,0,0,0,133,5,138
JHARKHAND,2011,Educational Standard - Holding technical degree/diploma etc,34,0,34,64,0,64,0,0,0,0,0,0,98,0,98
JHARKHAND,2012,Educational Standard,4135,144,4279,12435,600,13035,16,0,16,1,0,1,16587,744,17331
JHARKHAND,2012,Educational Standard - Illiterate,605,66,671,3104,290,3394,5,0,5,0,0,0,3714,356,4070
JHARKHAND,2012,Educational Standard - Below Class X,2079,56,2135,5579,208,5787,7,0,7,1,0,1,7666,264,7930
JHARKHAND,2012,Educational Standard - Class X and above but below graduate,1007,19,1026,2918,81,2999,3,0,3,0,0,0,3928,100,4028
JHARKHAND,2012,Educational Standard - Graduate,280,3,283,671,19,690,0,0,0,0,0,0,951,22,973
JHARKHAND,2012,Educational Standard - Post-Graduate,96,0,96,70,2,72,0,0,0,0,0,0,166,2,168
JHARKHAND,2012,Educational Standard - Holding technical degree/diploma etc,68,0,68,93,0,93,1,0,1,0,0,0,162,0,162
KARNATAKA,2001,Educational Standard,1849,54,1903,7517,199,7716,122,0,122,5,0,5,9493,253,9746
KARNATAKA,2001,Educational Standard - Illiterate,555,16,571,2631,69,2700,57,0,57,3,0,3,3246,85,3331
KARNATAKA,2001,Educational Standard - Below Class X,1109,32,1141,4134,127,4261,33,0,33,2,0,2,5278,159,5437
KARNATAKA,2001,Educational Standard - Class X and above but below graduate,132,6,138,677,2,679,28,0,28,0,0,0,837,8,845
KARNATAKA,2001,Educational Standard - Graduate,37,0,37,37,1,38,0,0,0,0,0,0,74,1,75
KARNATAKA,2001,Educational Standard - Post-Graduate,4,0,4,12,0,12,0,0,0,0,0,0,16,0,16
KARNATAKA,2001,Educational Standard - Holding technical degree/diploma etc,12,0,12,26,0,26,4,0,4,0,0,0,42,0,42
KARNATAKA,2002,Educational Standard,2215,83,2298,7709,263,7972,120,4,124,18,0,18,10062,350,10412
KARNATAKA,2002,Educational Standard - Illiterate,592,31,623,2741,86,2827,54,2,56,1,0,1,3388,119,3507
KARNATAKA,2002,Educational Standard - Below Class X,1261,41,1302,4178,142,4320,31,1,32,5,0,5,5475,184,5659
KARNATAKA,2002,Educational Standard - Class X and above but below graduate,287,8,295,702,27,729,26,0,26,8,0,8,1023,35,1058
KARNATAKA,2002,Educational Standard - Graduate,32,3,35,41,6,47,2,1,3,3,0,3,78,10,88
KARNATAKA,2002,Educational Standard - Post-Graduate,9,0,9,16,2,18,0,0,0,0,0,0,25,2,27
KARNATAKA,2002,Educational Standard - Holding technical degree/diploma etc,34,0,34,31,0,31,7,0,7,1,0,1,73,0,73
KARNATAKA,2004,Educational Standard,3321,126,3447,7655,307,7962,119,3,122,11,0,11,11106,436,11542
KARNATAKA,2004,Educational Standard - Illiterate,903,41,944,2661,97,2758,55,1,56,2,0,2,3621,139,3760
KARNATAKA,2004,Educational Standard - Below Class X,1657,52,1709,4145,168,4313,31,0,31,2,0,2,5835,220,6055
KARNATAKA,2004,Educational Standard - Class X and above but below graduate,574,12,586,703,23,726,27,1,28,3,0,3,1307,36,1343
KARNATAKA,2004,Educational Standard - Graduate,77,9,86,61,9,70,2,0,2,2,0,2,142,18,160
KARNATAKA,2004,Educational Standard - Post-Graduate,17,4,21,29,3,32,1,0,1,0,0,0,47,7,54
KARNATAKA,2004,Educational Standard - Holding technical degree/diploma etc,93,8,101,56,7,63,3,1,4,2,0,2,154,16,170
KARNATAKA,2005,Educational Standard,3905,144,4049,7683,296,7979,150,8,158,41,0,41,11779,448,12227
KARNATAKA,2005,Educational Standard - Illiterate,1168,27,1195,2627,91,2718,71,4,75,21,0,21,3887,122,4009
KARNATAKA,2005,Educational Standard - Below Class X,1913,74,1987,4197,161,4358,43,2,45,7,0,7,6160,237,6397
KARNATAKA,2005,Educational Standard - Class X and above but below graduate,617,14,631,701,24,725,29,1,30,3,0,3,1350,39,1389
KARNATAKA,2005,Educational Standard - Graduate,81,12,93,67,11,78,4,1,5,2,0,2,154,24,178
KARNATAKA,2005,Educational Standard - Post-Graduate,23,6,29,33,3,36,1,0,1,1,0,1,58,9,67
KARNATAKA,2005,Educational Standard - Holding technical degree/diploma etc,103,11,114,58,6,64,2,0,2,7,0,7,170,17,187
KARNATAKA,2006,Educational Standard,3667,185,3852,8338,311,8649,165,10,175,24,0,24,12194,506,12700
KARNATAKA,2006,Educational Standard - Illiterate,1068,52,1120,2978,94,3072,69,3,72,8,0,8,4123,149,4272
KARNATAKA,2006,Educational Standard - Below Class X,1794,83,1877,4437,169,4606,52,4,56,6,0,6,6289,256,6545
KARNATAKA,2006,Educational Standard - Class X and above but below graduate,583,19,602,743,27,770,34,2,36,3,0,3,1363,48,1411
KARNATAKA,2006,Educational Standard - Graduate,87,17,104,76,13,89,6,1,7,4,0,4,173,31,204
KARNATAKA,2006,Educational Standard - Post-Graduate,27,9,36,41,3,44,2,0,2,3,0,3,73,12,85
KARNATAKA,2006,Educational Standard - Holding technical degree/diploma etc,108,5,113,63,5,68,2,0,2,0,0,0,173,10,183
KARNATAKA,2007,Educational Standard,3660,170,3830,8694,352,9046,10,0,10,160,6,166,12524,528,13052
KARNATAKA,2007,Educational Standard - Illiterate,1058,51,1109,3012,104,3116,3,0,3,72,2,74,4145,157,4302
KARNATAKA,2007,Educational Standard - Below Class X,1743,64,1807,4611,191,4802,2,0,2,49,3,52,6405,258,6663
KARNATAKA,2007,Educational Standard - Class X and above but below graduate,601,21,622,825,27,852,3,0,3,27,1,28,1456,49,1505
KARNATAKA,2007,Educational Standard - Graduate,103,19,122,91,17,108,1,0,1,7,0,7,202,36,238
KARNATAKA,2007,Educational Standard - Post-Graduate,34,13,47,71,6,77,1,0,1,2,0,2,108,19,127
KARNATAKA,2007,Educational Standard - Holding technical degree/diploma etc,121,2,123,84,7,91,0,0,0,3,0,3,208,9,217
KARNATAKA,2008,Educational Standard,3780,179,3959,9054,354,9408,0,1,1,156,14,170,12990,548,13538
KARNATAKA,2008,Educational Standard - Illiterate,1097,51,1148,3263,103,3366,0,1,1,68,9,77,4428,164,4592
KARNATAKA,2008,Educational Standard - Below Class X,1773,66,1839,4697,193,4890,0,0,0,48,3,51,6518,262,6780
KARNATAKA,2008,Educational Standard - Class X and above but below graduate,631,27,658,829,28,857,0,0,0,28,1,29,1488,56,1544
KARNATAKA,2008,Educational Standard - Graduate,117,21,138,97,17,114,0,0,0,7,0,7,221,38,259
KARNATAKA,2008,Educational Standard - Post-Graduate,38,13,51,77,6,83,0,0,0,2,0,2,117,19,136
KARNATAKA,2008,Educational Standard - Holding technical degree/diploma etc,124,1,125,91,7,98,0,0,0,3,1,4,218,9,227
KARNATAKA,2009,Educational Standard,3567,151,3718,8960,361,9321,16,1,17,174,11,185,12717,524,13241
KARNATAKA,2009,Educational Standard - Illiterate,1168,38,1206,3161,107,3268,7,1,8,76,7,83,4412,153,4565
KARNATAKA,2009,Educational Standard - Below Class X,1485,51,1536,4703,195,4898,0,0,0,51,2,53,6239,248,6487
KARNATAKA,2009,Educational Standard - Class X and above but below graduate,631,27,658,831,28,859,4,0,4,32,1,33,1498,56,1554
KARNATAKA,2009,Educational Standard - Graduate,121,21,142,97,17,114,4,0,4,7,0,7,229,38,267
KARNATAKA,2009,Educational Standard - Post-Graduate,38,13,51,77,7,84,0,0,0,4,0,4,119,20,139
KARNATAKA,2009,Educational Standard - Holding technical degree/diploma etc,124,1,125,91,7,98,1,0,1,4,1,5,220,9,229
KARNATAKA,2010,Educational Standard,3758,165,3923,8476,300,8776,10,2,12,176,2,178,12420,469,12889
KARNATAKA,2010,Educational Standard - Illiterate,1295,46,1341,2894,97,2991,4,1,5,78,1,79,4271,145,4416
KARNATAKA,2010,Educational Standard - Below Class X,1551,54,1605,4478,151,4629,0,1,1,51,1,52,6080,207,6287
KARNATAKA,2010,Educational Standard - Class X and above but below graduate,631,31,662,807,21,828,3,0,3,32,0,32,1473,52,1525
KARNATAKA,2010,Educational Standard - Graduate,124,21,145,103,17,120,2,0,2,7,0,7,236,38,274
KARNATAKA,2010,Educational Standard - Post-Graduate,36,11,47,98,7,105,0,0,0,4,0,4,138,18,156
KARNATAKA,2010,Educational Standard - Holding technical degree/diploma etc,121,2,123,96,7,103,1,0,1,4,0,4,222,9,231
KARNATAKA,2011,Educational Standard,4033,188,4221,7960,326,8286,6,0,6,144,9,153,12143,523,12666
KARNATAKA,2011,Educational Standard - Illiterate,1433,54,1487,2634,127,2761,4,0,4,67,5,72,4138,186,4324
KARNATAKA,2011,Educational Standard - Below Class X,1684,61,1745,4189,141,4330,0,0,0,46,2,48,5919,204,6123
KARNATAKA,2011,Educational Standard - Class X and above but below graduate,629,37,666,798,28,826,2,0,2,23,2,25,1452,67,1519
KARNATAKA,2011,Educational Standard - Graduate,124,23,147,126,17,143,0,0,0,6,0,6,256,40,296
KARNATAKA,2011,Educational Standard - Post-Graduate,39,11,50,117,7,124,0,0,0,2,0,2,158,18,176
KARNATAKA,2011,Educational Standard - Holding technical degree/diploma etc,124,2,126,96,6,102,0,0,0,0,0,0,220,8,228
KARNATAKA,2012,Educational Standard,3913,187,4100,8572,368,8940,94,3,97,0,0,0,12579,558,13137
KARNATAKA,2012,Educational Standard - Illiterate,1332,57,1389,2786,156,2942,52,1,53,0,0,0,4170,214,4384
KARNATAKA,2012,Educational Standard - Below Class X,1609,62,1671,4373,147,4520,25,1,26,0,0,0,6007,210,6217
KARNATAKA,2012,Educational Standard - Class X and above but below graduate,641,31,672,841,37,878,11,1,12,0,0,0,1493,69,1562
KARNATAKA,2012,Educational Standard - Graduate,137,21,158,288,16,304,3,0,3,0,0,0,428,37,465
KARNATAKA,2012,Educational Standard - Post-Graduate,57,13,70,141,6,147,0,0,0,0,0,0,198,19,217
KARNATAKA,2012,Educational Standard - Holding technical degree/diploma etc,137,3,140,143,6,149,3,0,3,0,0,0,283,9,292
KERALA,2001,Educational Standard,1750,67,1817,3416,111,3527,19,0,19,13,0,13,5198,178,5376
KERALA,2001,Educational Standard - Illiterate,232,24,256,1028,40,1068,4,0,4,3,0,3,1267,64,1331
KERALA,2001,Educational Standard - Below Class X,1180,38,1218,1942,58,2000,5,0,5,10,0,10,3137,96,3233
KERALA,2001,Educational Standard - Class X and above but below graduate,308,5,313,402,13,415,10,0,10,0,0,0,720,18,738
KERALA,2001,Educational Standard - Graduate,25,0,25,30,0,30,0,0,0,0,0,0,55,0,55
KERALA,2001,Educational Standard - Post-Graduate,5,0,5,14,0,14,0,0,0,0,0,0,19,0,19
KERALA,2001,Educational Standard - Holding technical degree/diploma etc,0,0,0,0,0,0,0,0,0,0,0,0,0,0,0
KERALA,2002,Educational Standard,1661,50,1711,3321,137,3458,12,0,12,7,0,7,5001,187,5188
KERALA,2002,Educational Standard - Illiterate,204,10,214,952,38,990,0,0,0,0,0,0,1156,48,1204
KERALA,2002,Educational Standard - Below Class X,1186,31,1217,1925,82,2007,12,0,12,6,0,6,3129,113,3242
KERALA,2002,Educational Standard - Class X and above but below graduate,233,9,242,402,17,419,0,0,0,1,0,1,636,26,662
KERALA,2002,Educational Standard - Graduate,20,0,20,32,0,32,0,0,0,0,0,0,52,0,52
KERALA,2002,Educational Standard - Post-Graduate,12,0,12,6,0,6,0,0,0,0,0,0,18,0,18
KERALA,2002,Educational Standard - Holding technical degree/diploma etc,6,0,6,4,0,4,0,0,0,0,0,0,10,0,10
KERALA,2003,Educational Standard,2125,67,2192,4122,136,4258,8,0,8,6,0,6,6261,203,6464
KERALA,2003,Educational Standard - Illiterate,295,18,313,1152,40,1192,0,0,0,0,0,0,1447,58,1505
KERALA,2003,Educational Standard - Below Class X,1436,47,1483,2229,87,2316,0,0,0,6,0,6,3671,134,3805
KERALA,2003,Educational Standard - Class X and above but below graduate,298,2,300,669,9,678,8,0,8,0,0,0,975,11,986
KERALA,2003,Educational Standard - Graduate,32,0,32,40,0,40,0,0,0,0,0,0,72,0,72
KERALA,2003,Educational Standard - Post-Graduate,30,0,30,11,0,11,0,0,0,0,0,0,41,0,41
KERALA,2003,Educational Standard - Holding technical degree/diploma etc,34,0,34,21,0,21,0,0,0,0,0,0,55,0,55
KERALA,2004,Educational Standard,2696,84,2780,4246,154,4400,8,0,8,6,0,6,6956,238,7194
KERALA,2004,Educational Standard - Illiterate,295,18,313,1216,56,1272,0,0,0,0,0,0,1511,74,1585
KERALA,2004,Educational Standard - Below Class X,1636,57,1693,2273,89,2362,0,0,0,6,0,6,3915,146,4061
KERALA,2004,Educational Standard - Class X and above but below graduate,598,9,607,692,9,701,8,0,8,0,0,0,1298,18,1316
KERALA,2004,Educational Standard - Graduate,82,0,82,40,0,40,0,0,0,0,0,0,122,0,122
KERALA,2004,Educational Standard - Post-Graduate,46,0,46,11,0,11,0,0,0,0,0,0,57,0,57
KERALA,2004,Educational Standard - Holding technical degree/diploma etc,39,0,39,14,0,14,0,0,0,0,0,0,53,0,53
KERALA,2005,Educational Standard,2729,77,2806,3918,124,4042,13,0,13,2,0,2,6662,201,6863
KERALA,2005,Educational Standard - Illiterate,281,14,295,988,48,1036,0,0,0,0,0,0,1269,62,1331
KERALA,2005,Educational Standard - Below Class X,1667,59,1726,2181,71,2252,0,0,0,2,0,2,3850,130,3980
KERALA,2005,Educational Standard - Class X and above but below graduate,599,4,603,686,5,691,0,0,0,0,0,0,1285,9,1294
KERALA,2005,Educational Standard - Graduate,88,0,88,38,0,38,13,0,13,0,0,0,139,0,139
KERALA,2005,Educational Standard - Post-Graduate,49,0,49,9,0,9,0,0,0,0,0,0,58,0,58
KERALA,2005,Educational Standard - Holding technical degree/diploma etc,45,0,45,16,0,16,0,0,0,0,0,0,61,0,61
KERALA,2006,Educational Standard,2812,64,2876,3494,125,3619,5,0,5,4,0,4,6315,189,6504
KERALA,2006,Educational Standard - Illiterate,696,18,714,632,32,664,0,0,0,1,0,1,1329,50,1379
KERALA,2006,Educational Standard - Below Class X,1133,42,1175,1934,77,2011,2,0,2,1,0,1,3070,119,3189
KERALA,2006,Educational Standard - Class X and above but below graduate,712,4,716,767,14,781,3,0,3,2,0,2,1484,18,1502
KERALA,2006,Educational Standard - Graduate,226,0,226,142,1,143,0,0,0,0,0,0,368,1,369
KERALA,2006,Educational Standard - Post-Graduate,31,0,31,11,0,11,0,0,0,0,0,0,42,0,42
KERALA,2006,Educational Standard - Holding technical degree/diploma etc,14,0,14,8,1,9,0,0,0,0,0,0,22,1,23
KERALA,2007,Educational Standard,2858,58,2916,3662,125,3787,32,0,32,7,0,7,6559,183,6742
KERALA,2007,Educational Standard - Illiterate,429,14,443,712,32,744,10,0,10,0,0,0,1151,46,1197
KERALA,2007,Educational Standard - Below Class X,1576,29,1605,1964,78,2042,12,0,12,2,0,2,3554,107,3661
KERALA,2007,Educational Standard - Class X and above but below graduate,669,10,679,793,14,807,8,0,8,5,0,5,1475,24,1499
KERALA,2007,Educational Standard - Graduate,141,3,144,173,1,174,2,0,2,0,0,0,316,4,320
KERALA,2007,Educational Standard - Post-Graduate,21,0,21,13,0,13,0,0,0,0,0,0,34,0,34
KERALA,2007,Educational Standard - Holding technical degree/diploma etc,22,2,24,7,0,7,0,0,0,0,0,0,29,2,31
KERALA,2008,Educational Standard,2696,54,2750,3806,128,3934,41,0,41,7,0,7,6550,182,6732
KERALA,2008,Educational Standard - Illiterate,258,11,269,947,22,969,10,0,10,0,0,0,1215,33,1248
KERALA,2008,Educational Standard - Below Class X,1410,35,1445,1693,102,1795,18,0,18,2,0,2,3123,137,3260
KERALA,2008,Educational Standard - Class X and above but below graduate,825,6,831,836,3,839,10,0,10,5,0,5,1676,9,1685
KERALA,2008,Educational Standard - Graduate,86,2,88,188,1,189,3,0,3,0,0,0,277,3,280
KERALA,2008,Educational Standard - Post-Graduate,19,0,19,15,0,15,0,0,0,0,0,0,34,0,34
KERALA,2008,Educational Standard - Holding technical degree/diploma etc,98,0,98,127,0,127,0,0,0,0,0,0,225,0,225
KERALA,2009,Educational Standard,2767,53,2820,3925,153,4078,70,0,70,3,0,3,6765,206,6971
KERALA,2009,Educational Standard - Illiterate,402,29,431,599,48,647,22,0,22,0,0,0,1023,77,1100
KERALA,2009,Educational Standard - Below Class X,1528,17,1545,2200,85,2285,34,0,34,0,0,0,3762,102,3864
KERALA,2009,Educational Standard - Class X and above but below graduate,672,6,678,998,13,1011,12,0,12,3,0,3,1685,19,1704
KERALA,2009,Educational Standard - Graduate,132,1,133,95,5,100,2,0,2,0,0,0,229,6,235
KERALA,2009,Educational Standard - Post-Graduate,8,0,8,7,0,7,0,0,0,0,0,0,15,0,15
KERALA,2009,Educational Standard - Holding technical degree/diploma etc,25,0,25,26,2,28,0,0,0,0,0,0,51,2,53
KERALA,2010,Educational Standard,2734,50,2784,3737,162,3899,6,0,6,3,0,3,6480,212,6692
KERALA,2010,Educational Standard - Illiterate,253,27,280,352,36,388,0,0,0,0,0,0,605,63,668
KERALA,2010,Educational Standard - Below Class X,1551,16,1567,2219,89,2308,6,0,6,3,0,3,3779,105,3884
KERALA,2010,Educational Standard - Class X and above but below graduate,754,6,760,1060,29,1089,0,0,0,0,0,0,1814,35,1849
KERALA,2010,Educational Standard - Graduate,140,1,141,69,5,74,0,0,0,0,0,0,209,6,215
KERALA,2010,Educational Standard - Post-Graduate,10,0,10,7,0,7,0,0,0,0,0,0,17,0,17
KERALA,2010,Educational Standard - Holding technical degree/diploma etc,26,0,26,30,3,33,0,0,0,0,0,0,56,3,59
KERALA,2011,Educational Standard,2386,55,2441,3660,115,3775,8,0,8,3,2,5,6057,172,6229
KERALA,2011,Educational Standard - Illiterate,233,27,260,347,37,384,0,0,0,0,0,0,580,64,644
KERALA,2011,Educational Standard - Below Class X,1277,21,1298,2158,46,2204,0,0,0,0,0,0,3435,67,3502
KERALA,2011,Educational Standard - Class X and above but below graduate,724,6,730,1062,27,1089,6,0,6,2,2,4,1794,35,1829
KERALA,2011,Educational Standard - Graduate,120,1,121,59,5,64,2,0,2,1,0,1,182,6,188
KERALA,2011,Educational Standard - Post-Graduate,10,0,10,18,0,18,0,0,0,0,0,0,28,0,28
KERALA,2011,Educational Standard - Holding technical degree/diploma etc,22,0,22,16,0,16,0,0,0,0,0,0,38,0,38
KERALA,2012,Educational Standard,2710,56,2766,4020,145,4165,9,0,9,4,3,7,6743,204,6947
KERALA,2012,Educational Standard - Illiterate,333,26,359,408,52,460,0,0,0,0,0,0,741,78,819
KERALA,2012,Educational Standard - Below Class X,1496,22,1518,2262,38,2300,0,0,0,0,0,0,3758,60,3818
KERALA,2012,Educational Standard - Class X and above but below graduate,725,8,733,1172,21,1193,5,0,5,2,0,2,1904,29,1933
KERALA,2012,Educational Standard - Graduate,122,0,122,101,32,133,4,0,4,2,3,5,229,35,264
KERALA,2012,Educational Standard - Post-Graduate,11,0,11,60,2,62,0,0,0,0,0,0,71,2,73
KERALA,2012,Educational Standard - Holding technical degree/diploma etc,23,0,23,17,0,17,0,0,0,0,0,0,40,0,40
MADHYA PRADESH,2001,Educational Standard,11933,262,12195,16382,455,16837,16,0,16,39,0,39,28370,717,29087
MADHYA PRADESH,2001,Educational Standard - Illiterate,4842,188,5030,6764,299,7063,2,0,2,15,0,15,11623,487,12110
MADHYA PRADESH,2001,Educational Standard - Below Class X,5028,64,5092,6733,136,6869,9,0,9,10,0,10,11780,200,11980
MADHYA PRADESH,2001,Educational Standard - Class X and above but below graduate,1554,9,1563,2269,17,2286,5,0,5,14,0,14,3842,26,3868
MADHYA PRADESH,2001,Educational Standard - Graduate,395,1,396,435,3,438,0,0,0,0,0,0,830,4,834
MADHYA PRADESH,2001,Educational Standard - Post-Graduate,93,0,93,107,0,107,0,0,0,0,0,0,200,0,200
MADHYA PRADESH,2001,Educational Standard - Holding technical degree/diploma etc,21,0,21,74,0,74,0,0,0,0,0,0,95,0,95
MADHYA PRADESH,2002,Educational Standard,11797,260,12057,15176,459,15635,16,0,16,58,1,59,27047,720,27767
MADHYA PRADESH,2002,Educational Standard - Illiterate,4971,142,5113,5264,323,5587,0,0,0,32,1,33,10267,466,10733
MADHYA PRADESH,2002,Educational Standard - Below Class X,5612,100,5712,7166,114,7280,10,0,10,19,0,19,12807,214,13021
MADHYA PRADESH,2002,Educational Standard - Class X and above but below graduate,862,15,877,1702,18,1720,6,0,6,5,0,5,2575,33,2608
MADHYA PRADESH,2002,Educational Standard - Graduate,252,3,255,839,1,840,0,0,0,2,0,2,1093,4,1097
MADHYA PRADESH,2002,Educational Standard - Post-Graduate,83,0,83,156,2,158,0,0,0,0,0,0,239,2,241
MADHYA PRADESH,2002,Educational Standard - Holding technical degree/diploma etc,17,0,17,49,1,50,0,0,0,0,0,0,66,1,67
MADHYA PRADESH,2003,Educational Standard,12235,545,12780,13538,455,13993,13,0,13,46,0,46,25832,1000,26832
MADHYA PRADESH,2003,Educational Standard - Illiterate,5476,284,5760,6626,233,6859,0,0,0,23,0,23,12125,517,12642
MADHYA PRADESH,2003,Educational Standard - Below Class X,5071,231,5302,4725,149,4874,5,0,5,16,0,16,9817,380,10197
MADHYA PRADESH,2003,Educational Standard - Class X and above but below graduate,1359,25,1384,1557,64,1621,8,0,8,4,0,4,2928,89,3017
MADHYA PRADESH,2003,Educational Standard - Graduate,232,5,237,417,9,426,0,0,0,3,0,3,652,14,666
MADHYA PRADESH,2003,Educational Standard - Post-Graduate,75,0,75,181,0,181,0,0,0,0,0,0,256,0,256
MADHYA PRADESH,2003,Educational Standard - Holding technical degree/diploma etc,22,0,22,32,0,32,0,0,0,0,0,0,54,0,54
MADHYA PRADESH,2004,Educational Standard,12797,269,13066,15316,461,15777,5,0,5,84,0,84,28202,730,28932
MADHYA PRADESH,2004,Educational Standard - Illiterate,5313,185,5498,6632,292,6924,1,0,1,31,0,31,11977,477,12454
MADHYA PRADESH,2004,Educational Standard - Below Class X,5264,55,5319,6120,125,6245,1,0,1,25,0,25,11410,180,11590
MADHYA PRADESH,2004,Educational Standard - Class X and above but below graduate,1685,27,1712,2158,41,2199,1,0,1,20,0,20,3864,68,3932
MADHYA PRADESH,2004,Educational Standard - Graduate,370,1,371,248,2,250,1,0,1,5,0,5,624,3,627
MADHYA PRADESH,2004,Educational Standard - Post-Graduate,127,1,128,136,1,137,1,0,1,3,0,3,267,2,269
MADHYA PRADESH,2004,Educational Standard - Holding technical degree/diploma etc,38,0,38,22,0,22,0,0,0,0,0,0,60,0,60
MADHYA PRADESH,2005,Educational Standard,14094,297,14391,16471,520,16991,21,0,21,77,0,77,30663,817,31480
MADHYA PRADESH,2005,Educational Standard - Illiterate,3959,190,4149,6148,345,6493,2,0,2,24,0,24,10133,535,10668
MADHYA PRADESH,2005,Educational Standard - Below Class X,6636,90,6726,6840,138,6978,14,0,14,34,0,34,13524,228,13752
MADHYA PRADESH,2005,Educational Standard - Class X and above but below graduate,2714,10,2724,2574,31,2605,5,0,5,16,0,16,5309,41,5350
MADHYA PRADESH,2005,Educational Standard - Graduate,556,3,559,658,6,664,0,0,0,3,0,3,1217,9,1226
MADHYA PRADESH,2005,Educational Standard - Post-Graduate,176,4,180,199,0,199,0,0,0,0,0,0,375,4,379
MADHYA PRADESH,2005,Educational Standard - Holding technical degree/diploma etc,53,0,53,52,0,52,0,0,0,0,0,0,105,0,105
MADHYA PRADESH,2006,Educational Standard,14866,349,15215,16259,427,16686,21,0,21,75,3,78,31221,779,32000
MADHYA PRADESH,2006,Educational Standard - Illiterate,4211,173,4384,5597,243,5840,0,0,0,19,3,22,9827,419,10246
MADHYA PRADESH,2006,Educational Standard - Below Class X,7405,149,7554,7536,155,7691,10,0,10,37,0,37,14988,304,15292
MADHYA PRADESH,2006,Educational Standard - Class X and above but below graduate,2358,23,2381,2200,25,2225,8,0,8,14,0,14,4580,48,4628
MADHYA PRADESH,2006,Educational Standard - Graduate,644,3,647,680,3,683,3,0,3,5,0,5,1332,6,1338
MADHYA PRADESH,2006,Educational Standard - Post-Graduate,194,1,195,198,1,199,0,0,0,0,0,0,392,2,394
MADHYA PRADESH,2006,Educational Standard - Holding technical degree/diploma etc,54,0,54,48,0,48,0,0,0,0,0,0,102,0,102
MADHYA PRADESH,2007,Educational Standard,15940,373,16313,15819,481,16300,34,0,34,65,0,65,31858,854,32712
MADHYA PRADESH,2007,Educational Standard - Illiterate,4757,149,4906,4899,245,5144,4,0,4,20,0,20,9680,394,10074
MADHYA PRADESH,2007,Educational Standard - Below Class X,8313,178,8491,7523,199,7722,20,0,20,34,0,34,15890,377,16267
MADHYA PRADESH,2007,Educational Standard - Class X and above but below graduate,2107,39,2146,2437,32,2469,7,0,7,7,0,7,4558,71,4629
MADHYA PRADESH,2007,Educational Standard - Graduate,568,5,573,683,2,685,2,0,2,3,0,3,1256,7,1263
MADHYA PRADESH,2007,Educational Standard - Post-Graduate,147,2,149,223,2,225,1,0,1,1,0,1,372,4,376
MADHYA PRADESH,2007,Educational Standard - Holding technical degree/diploma etc,48,0,48,54,1,55,0,0,0,0,0,0,102,1,103
MADHYA PRADESH,2008,Educational Standard,15706,396,16102,17902,586,18488,103,0,103,62,0,62,33773,982,34755
MADHYA PRADESH,2008,Educational Standard - Illiterate,5164,186,5350,5555,335,5890,23,0,23,27,0,27,10769,521,11290
MADHYA PRADESH,2008,Educational Standard - Below Class X,7469,165,7634,7962,190,8152,49,0,49,30,0,30,15510,355,15865
MADHYA PRADESH,2008,Educational Standard - Class X and above but below graduate,2227,32,2259,3338,45,3383,28,0,28,3,0,3,5596,77,5673
MADHYA PRADESH,2008,Educational Standard - Graduate,496,10,506,729,12,741,2,0,2,2,0,2,1229,22,1251
MADHYA PRADESH,2008,Educational Standard - Post-Graduate,173,3,176,252,2,254,1,0,1,0,0,0,426,5,431
MADHYA PRADESH,2008,Educational Standard - Holding technical degree/diploma etc,177,0,177,66,2,68,0,0,0,0,0,0,243,2,245
MADHYA PRADESH,2009,Educational Standard,14967,400,15367,16780,531,17311,51,0,51,77,0,77,31875,931,32806
MADHYA PRADESH,2009,Educational Standard - Illiterate,5277,197,5474,5207,269,5476,9,0,9,33,0,33,10526,466,10992
MADHYA PRADESH,2009,Educational Standard - Below Class X,6473,151,6624,7291,199,7490,32,0,32,35,0,35,13831,350,14181
MADHYA PRADESH,2009,Educational Standard - Class X and above but below graduate,2603,44,2647,3473,52,3525,9,0,9,6,0,6,6091,96,6187
MADHYA PRADESH,2009,Educational Standard - Graduate,414,5,419,530,9,539,0,0,0,3,0,3,947,14,961
MADHYA PRADESH,2009,Educational Standard - Post-Graduate,136,3,139,224,2,226,1,0,1,0,0,0,361,5,366
MADHYA PRADESH,2009,Educational Standard - Holding technical degree/diploma etc,64,0,64,55,0,55,0,0,0,0,0,0,119,0,119
MADHYA PRADESH,2010,Educational Standard,14167,412,14579,15948,574,16522,86,0,86,122,9,131,30323,995,31318
MADHYA PRADESH,2010,Educational Standard - Illiterate,4251,188,4439,5380,300,5680,17,0,17,56,6,62,9704,494,10198
MADHYA PRADESH,2010,Educational Standard - Below Class X,6729,162,6891,6338,206,6544,45,0,45,48,2,50,13160,370,13530
MADHYA PRADESH,2010,Educational Standard - Class X and above but below graduate,2622,50,2672,3466,56,3522,21,0,21,15,1,16,6124,107,6231
MADHYA PRADESH,2010,Educational Standard - Graduate,374,9,383,473,11,484,3,0,3,3,0,3,853,20,873
MADHYA PRADESH,2010,Educational Standard - Post-Graduate,127,3,130,214,1,215,0,0,0,0,0,0,341,4,345
MADHYA PRADESH,2010,Educational Standard - Holding technical degree/diploma etc,64,0,64,77,0,77,0,0,0,0,0,0,141,0,141
MADHYA PRADESH,2011,Educational Standard,15502,454,15956,16071,630,16701,132,0,132,126,1,127,31831,1085,32916
MADHYA PRADESH,2011,Educational Standard - Illiterate,3966,246,4212,4178,335,4513,16,0,16,41,1,42,8201,582,8783
MADHYA PRADESH,2011,Educational Standard - Below Class X,8277,156,8433,7984,224,8208,59,0,59,63,0,63,16383,380,16763
MADHYA PRADESH,2011,Educational Standard - Class X and above but below graduate,2653,38,2691,3218,53,3271,50,0,50,16,0,16,5937,91,6028
MADHYA PRADESH,2011,Educational Standard - Graduate,418,7,425,441,15,456,5,0,5,6,0,6,870,22,892
MADHYA PRADESH,2011,Educational Standard - Post-Graduate,125,6,131,206,3,209,2,0,2,0,0,0,333,9,342
MADHYA PRADESH,2011,Educational Standard - Holding technical degree/diploma etc,63,1,64,44,0,44,0,0,0,0,0,0,107,1,108
MADHYA PRADESH,2012,Educational Standard,15631,494,16125,16933,686,17619,138,1,139,76,0,76,32778,1181,33959
MADHYA PRADESH,2012,Educational Standard - Illiterate,4832,284,5116,4611,386,4997,7,0,7,30,0,30,9480,670,10150
MADHYA PRADESH,2012,Educational Standard - Below Class X,8275,175,8450,8737,244,8981,99,1,100,35,0,35,17146,420,17566
MADHYA PRADESH,2012,Educational Standard - Class X and above but below graduate,1892,20,1912,2831,35,2866,26,0,26,4,0,4,4753,55,4808
MADHYA PRADESH,2012,Educational Standard - Graduate,427,10,437,497,13,510,5,0,5,4,0,4,933,23,956
MADHYA PRADESH,2012,Educational Standard - Post-Graduate,151,5,156,203,5,208,1,0,1,2,0,2,357,10,367
MADHYA PRADESH,2012,Educational Standard - Holding technical degree/diploma etc,54,0,54,54,3,57,0,0,0,1,0,1,109,3,112
MAHARASHTRA,2001,Educational Standard,6433,279,6712,14863,583,15446,364,1,365,4,0,4,21664,863,22527
MAHARASHTRA,2001,Educational Standard - Illiterate,1491,151,1642,4484,279,4763,84,0,84,0,0,0,6059,430,6489
MAHARASHTRA,2001,Educational Standard - Below Class X,3704,112,3816,7843,225,8068,175,0,175,4,0,4,11726,337,12063
MAHARASHTRA,2001,Educational Standard - Class X and above but below graduate,1061,12,1073,2115,73,2188,71,1,72,0,0,0,3247,86,3333
MAHARASHTRA,2001,Educational Standard - Graduate,142,4,146,284,5,289,27,0,27,0,0,0,453,9,462
MAHARASHTRA,2001,Educational Standard - Post-Graduate,21,0,21,86,1,87,7,0,7,0,0,0,114,1,115
MAHARASHTRA,2001,Educational Standard - Holding technical degree/diploma etc,14,0,14,51,0,51,0,0,0,0,0,0,65,0,65
MAHARASHTRA,2002,Educational Standard,6887,311,7198,13869,648,14517,299,8,307,0,0,0,21055,967,22022
MAHARASHTRA,2002,Educational Standard - Illiterate,1450,66,1516,3815,309,4124,23,0,23,0,0,0,5288,375,5663
MAHARASHTRA,2002,Educational Standard - Below Class X,4018,227,4245,6589,212,6801,155,5,160,0,0,0,10762,444,11206
MAHARASHTRA,2002,Educational Standard - Class X and above but below graduate,1132,11,1143,2493,64,2557,100,1,101,0,0,0,3725,76,3801
MAHARASHTRA,2002,Educational Standard - Graduate,171,7,178,489,25,514,18,2,20,0,0,0,678,34,712
MAHARASHTRA,2002,Educational Standard - Post-Graduate,64,0,64,204,24,228,1,0,1,0,0,0,269,24,293
MAHARASHTRA,2002,Educational Standard - Holding technical degree/diploma etc,52,0,52,279,14,293,2,0,2,0,0,0,333,14,347
MAHARASHTRA,2003,Educational Standard,7825,390,8215,14776,728,15504,188,1,189,21,0,21,22810,1119,23929
MAHARASHTRA,2003,Educational Standard,0,0,0,0,0,0,0,0,0,0,0,0,0,0,0
MAHARASHTRA,2003,Educational Standard - Illiterate,2006,98,2104,3650,418,4068,19,0,19,0,0,0,5675,516,6191
MAHARASHTRA,2003,Educational Standard - Below Class X,3973,261,4234,8202,257,8459,102,1,103,17,0,17,12294,519,12813
MAHARASHTRA,2003,Educational Standard - Class X and above but below graduate,1488,27,1515,2138,36,2174,53,0,53,3,0,3,3682,63,3745
MAHARASHTRA,2003,Educational Standard - Graduate,251,4,255,477,9,486,10,0,10,1,0,1,739,13,752
MAHARASHTRA,2003,Educational Standard - Post-Graduate,70,0,70,168,1,169,3,0,3,0,0,0,241,1,242
MAHARASHTRA,2003,Educational Standard - Holding technical degree/diploma etc,37,0,37,141,7,148,1,0,1,0,0,0,179,7,186
MAHARASHTRA,2004,Educational Standard,8447,484,8931,15012,772,15784,170,0,170,37,0,37,23666,1256,24922
MAHARASHTRA,2004,Educational Standard - Illiterate,2405,231,2636,3530,468,3998,18,0,18,4,0,4,5957,699,6656
MAHARASHTRA,2004,Educational Standard - Below Class X,3891,239,4130,7327,245,7572,101,0,101,32,0,32,11351,484,11835
MAHARASHTRA,2004,Educational Standard - Class X and above but below graduate,1626,8,1634,3402,27,3429,29,0,29,1,0,1,5058,35,5093
MAHARASHTRA,2004,Educational Standard - Graduate,360,6,366,452,31,483,13,0,13,0,0,0,825,37,862
MAHARASHTRA,2004,Educational Standard - Post-Graduate,110,0,110,174,0,174,6,0,6,0,0,0,290,0,290
MAHARASHTRA,2004,Educational Standard - Holding technical degree/diploma etc,55,0,55,127,1,128,3,0,3,0,0,0,185,1,186
MAHARASHTRA,2005,Educational Standard,8766,463,9229,15084,862,15946,234,1,235,21,0,21,24105,1326,25431
MAHARASHTRA,2005,Educational Standard - Illiterate,2084,107,2191,3212,383,3595,11,0,11,3,0,3,5310,490,5800
MAHARASHTRA,2005,Educational Standard - Below Class X,4430,211,4641,8714,374,9088,117,0,117,18,0,18,13279,585,13864
MAHARASHTRA,2005,Educational Standard - Class X and above but below graduate,1837,145,1982,2469,85,2554,66,0,66,0,0,0,4372,230,4602
MAHARASHTRA,2005,Educational Standard - Graduate,348,0,348,493,20,513,32,1,33,0,0,0,873,21,894
MAHARASHTRA,2005,Educational Standard - Post-Graduate,46,0,46,123,0,123,3,0,3,0,0,0,172,0,172
MAHARASHTRA,2005,Educational Standard - Holding technical degree/diploma etc,21,0,21,73,0,73,5,0,5,0,0,0,99,0,99
MAHARASHTRA,2006,Educational Standard,8700,449,9149,15454,911,16365,273,1,274,1,0,1,24428,1361,25789
MAHARASHTRA,2006,Educational Standard - Illiterate,1388,266,1654,3150,539,3689,28,0,28,1,0,1,4567,805,5372
MAHARASHTRA,2006,Educational Standard - Below Class X,4730,133,4863,8034,276,8310,113,0,113,0,0,0,12877,409,13286
MAHARASHTRA,2006,Educational Standard - Class X and above but below graduate,2173,48,2221,3325,83,3408,96,1,97,0,0,0,5594,132,5726
MAHARASHTRA,2006,Educational Standard - Graduate,293,2,295,601,12,613,29,0,29,0,0,0,923,14,937
MAHARASHTRA,2006,Educational Standard - Post-Graduate,66,0,66,193,1,194,7,0,7,0,0,0,266,1,267
MAHARASHTRA,2006,Educational Standard - Holding technical degree/diploma etc,50,0,50,151,0,151,0,0,0,0,0,0,201,0,201
MAHARASHTRA,2007,Educational Standard,8692,511,9203,15696,841,16537,151,1,152,0,0,0,24539,1353,25892
MAHARASHTRA,2007,Educational Standard - Illiterate,1404,274,1678,3784,419,4203,21,0,21,0,0,0,5209,693,5902
MAHARASHTRA,2007,Educational Standard - Below Class X,4881,186,5067,7265,346,7611,60,1,61,0,0,0,12206,533,12739
MAHARASHTRA,2007,Educational Standard - Class X and above but below graduate,1870,34,1904,3217,49,3266,49,0,49,0,0,0,5136,83,5219
MAHARASHTRA,2007,Educational Standard - Graduate,435,5,440,772,25,797,18,0,18,0,0,0,1225,30,1255
MAHARASHTRA,2007,Educational Standard - Post-Graduate,67,9,76,463,2,465,3,0,3,0,0,0,533,11,544
MAHARASHTRA,2007,Educational Standard - Holding technical degree/diploma etc,35,3,38,195,0,195,0,0,0,0,0,0,230,3,233
MAHARASHTRA,2008,Educational Standard,8665,499,9164,15618,936,16554,111,2,113,0,0,0,24394,1437,25831
MAHARASHTRA,2008,Educational Standard - Illiterate,1525,205,1730,3834,520,4354,30,0,30,0,0,0,5389,725,6114
MAHARASHTRA,2008,Educational Standard - Below Class X,4542,212,4754,6654,302,6956,60,1,61,0,0,0,11256,515,11771
MAHARASHTRA,2008,Educational Standard - Class X and above but below graduate,2186,69,2255,3719,88,3807,15,1,16,0,0,0,5920,158,6078
MAHARASHTRA,2008,Educational Standard - Graduate,278,10,288,700,20,720,3,0,3,0,0,0,981,30,1011
MAHARASHTRA,2008,Educational Standard - Post-Graduate,73,3,76,481,4,485,0,0,0,0,0,0,554,7,561
MAHARASHTRA,2008,Educational Standard - Holding technical degree/diploma etc,61,0,61,230,2,232,3,0,3,0,0,0,294,2,296
MAHARASHTRA,2009,Educational Standard,8093,529,8622,15227,953,16180,82,0,82,0,0,0,23402,1482,24884
MAHARASHTRA,2009,Educational Standard - Illiterate,1479,238,1717,4008,470,4478,11,0,11,0,0,0,5498,708,6206
MAHARASHTRA,2009,Educational Standard - Below Class X,3967,164,4131,6474,304,6778,59,0,59,0,0,0,10500,468,10968
MAHARASHTRA,2009,Educational Standard - Class X and above but below graduate,2175,119,2294,3750,132,3882,11,0,11,0,0,0,5936,251,6187
MAHARASHTRA,2009,Educational Standard - Graduate,352,7,359,629,39,668,1,0,1,0,0,0,982,46,1028
MAHARASHTRA,2009,Educational Standard - Post-Graduate,90,1,91,231,5,236,0,0,0,0,0,0,321,6,327
MAHARASHTRA,2009,Educational Standard - Holding technical degree/diploma etc,30,0,30,135,3,138,0,0,0,0,0,0,165,3,168
MAHARASHTRA,2010,Educational Standard,7690,449,8139,15219,846,16065,75,2,77,0,0,0,22984,1297,24281
MAHARASHTRA,2010,Educational Standard - Illiterate,1113,171,1284,3588,324,3912,2,1,3,0,0,0,4703,496,5199
MAHARASHTRA,2010,Educational Standard - Below Class X,4193,169,4362,6834,255,7089,50,0,50,0,0,0,11077,424,11501
MAHARASHTRA,2010,Educational Standard - Graduate,296,6,302,698,29,727,5,1,6,0,0,0,999,36,1035
MAHARASHTRA,2010,Educational Standard - Post-Graduate,78,0,78,295,0,295,0,0,0,0,0,0,373,0,373
MAHARASHTRA,2010,Educational Standard - Holding technical degree/diploma etc,23,0,23,78,0,78,0,0,0,0,0,0,101,0,101
MAHARASHTRA,2011,Educational Standard,7491,461,7952,15149,915,16064,66,0,66,0,0,0,22706,1376,24082
MAHARASHTRA,2011,Educational Standard - Illiterate,1119,134,1253,2515,280,2795,2,0,2,0,0,0,3636,414,4050
MAHARASHTRA,2011,Educational Standard - Below Class X,4386,221,4607,7133,522,7655,56,0,56,0,0,0,11575,743,12318
MAHARASHTRA,2011,Educational Standard - Class X and above but below graduate,1654,97,1751,4498,94,4592,7,0,7,0,0,0,6159,191,6350
MAHARASHTRA,2011,Educational Standard - Graduate,253,9,262,733,19,752,1,0,1,0,0,0,987,28,1015
MAHARASHTRA,2011,Educational Standard - Post-Graduate,55,0,55,242,0,242,0,0,0,0,0,0,297,0,297
MAHARASHTRA,2011,Educational Standard - Holding technical degree/diploma etc,24,0,24,28,0,28,0,0,0,0,0,0,52,0,52
MAHARASHTRA,2012,Educational Standard,7569,457,8026,15545,881,16426,42,0,42,15,0,15,23171,1338,24509
MAHARASHTRA,2012,Educational Standard - Illiterate,997,86,1083,3378,270,3648,14,0,14,1,0,1,4390,356,4746
MAHARASHTRA,2012,Educational Standard - Below Class X,4420,297,4717,7274,278,7552,16,0,16,14,0,14,11724,575,12299
MAHARASHTRA,2012,Educational Standard - Class X and above but below graduate,1610,60,1670,3119,327,3446,12,0,12,0,0,0,4741,387,5128
MAHARASHTRA,2012,Educational Standard - Graduate,313,12,325,1131,3,1134,0,0,0,0,0,0,1444,15,1459
MAHARASHTRA,2012,Educational Standard - Post-Graduate,114,2,116,424,3,427,0,0,0,0,0,0,538,5,543
MAHARASHTRA,2012,Educational Standard - Holding technical degree/diploma etc,115,0,115,219,0,219,0,0,0,0,0,0,334,0,334
MANIPUR,2001,Educational Standard,22,0,22,331,13,344,85,11,96,0,0,0,438,24,462
MANIPUR,2001,Educational Standard - Illiterate,3,0,3,24,3,27,8,0,8,0,0,0,35,3,38
MANIPUR,2001,Educational Standard - Below Class X,17,0,17,230,10,240,50,2,52,0,0,0,297,12,309
MANIPUR,2001,Educational Standard - Class X and above but below graduate,2,0,2,73,0,73,25,7,32,0,0,0,100,7,107
MANIPUR,2001,Educational Standard - Graduate,0,0,0,4,0,4,2,1,3,0,0,0,6,1,7
MANIPUR,2001,Educational Standard - Post-Graduate,0,0,0,0,0,0,0,1,1,0,0,0,0,1,1
MANIPUR,2001,Educational Standard - Holding technical degree/diploma etc,0,0,0,0,0,0,0,0,0,0,0,0,0,0,0
MANIPUR,2002,Educational Standard,36,1,37,339,21,360,113,6,119,0,0,0,488,28,516
MANIPUR,2002,Educational Standard - Illiterate,1,1,2,14,2,16,5,2,7,0,0,0,20,5,25
MANIPUR,2002,Educational Standard - Below Class X,30,0,30,299,19,318,60,2,62,0,0,0,389,21,410
MANIPUR,2002,Educational Standard - Class X and above but below graduate,3,0,3,21,0,21,45,2,47,0,0,0,69,2,71
MANIPUR,2002,Educational Standard - Graduate,2,0,2,5,0,5,3,0,3,0,0,0,10,0,10
MANIPUR,2002,Educational Standard - Post-Graduate,0,0,0,0,0,0,0,0,0,0,0,0,0,0,0
MANIPUR,2002,Educational Standard - Holding technical degree/diploma etc,0,0,0,0,0,0,0,0,0,0,0,0,0,0,0
MANIPUR,2003,Educational Standard,32,1,33,343,18,361,130,8,138,0,0,0,505,27,532
MANIPUR,2003,Educational Standard - Illiterate,2,1,3,51,5,56,8,1,9,0,0,0,61,7,68
MANIPUR,2003,Educational Standard - Below Class X,26,0,26,218,11,229,74,6,80,0,0,0,318,17,335
MANIPUR,2003,Educational Standard - Class X and above but below graduate,3,0,3,58,2,60,43,1,44,0,0,0,104,3,107
MANIPUR,2003,Educational Standard - Graduate,1,0,1,15,0,15,4,0,4,0,0,0,20,0,20
MANIPUR,2003,Educational Standard - Post-Graduate,0,0,0,1,0,1,1,0,1,0,0,0,2,0,2
MANIPUR,2003,Educational Standard - Holding technical degree/diploma etc,0,0,0,0,0,0,0,0,0,0,0,0,0,0,0
MANIPUR,2004,Educational Standard,32,0,32,338,21,359,72,2,74,0,0,0,442,23,465
MANIPUR,2004,Educational Standard - Illiterate,8,0,8,16,3,19,2,0,2,0,0,0,26,3,29
MANIPUR,2004,Educational Standard - Below Class X,17,0,17,243,14,257,31,0,31,0,0,0,291,14,305
MANIPUR,2004,Educational Standard - Class X and above but below graduate,4,0,4,61,4,65,32,2,34,0,0,0,97,6,103
MANIPUR,2004,Educational Standard - Graduate,2,0,2,18,0,18,7,0,7,0,0,0,27,0,27
MANIPUR,2004,Educational Standard - Post-Graduate,1,0,1,0,0,0,0,0,0,0,0,0,1,0,1
MANIPUR,2004,Educational Standard - Holding technical degree/diploma etc,0,0,0,0,0,0,0,0,0,0,0,0,0,0,0
MANIPUR,2005,Educational Standard,31,0,31,376,19,395,96,7,103,0,0,0,503,26,529
MANIPUR,2005,Educational Standard - Illiterate,3,0,3,41,1,42,5,1,6,0,0,0,49,2,51
MANIPUR,2005,Educational Standard - Below Class X,21,0,21,185,3,188,56,5,61,0,0,0,262,8,270
MANIPUR,2005,Educational Standard - Class X and above but below graduate,2,0,2,121,14,135,29,1,30,0,0,0,152,15,167
MANIPUR,2005,Educational Standard - Graduate,4,0,4,24,0,24,5,0,5,0,0,0,33,0,33
MANIPUR,2005,Educational Standard - Post-Graduate,0,0,0,3,1,4,0,0,0,0,0,0,3,1,4
MANIPUR,2005,Educational Standard - Holding technical degree/diploma etc,1,0,1,2,0,2,1,0,1,0,0,0,4,0,4
MANIPUR,2006,Educational Standard,33,0,33,308,15,323,42,0,42,0,0,0,383,15,398
MANIPUR,2006,Educational Standard - Illiterate,0,0,0,20,1,21,1,0,1,0,0,0,21,1,22
MANIPUR,2006,Educational Standard - Below Class X,30,0,30,248,14,262,32,0,32,0,0,0,310,14,324
MANIPUR,2006,Educational Standard - Class X and above but below graduate,0,0,0,34,0,34,9,0,9,0,0,0,43,0,43
MANIPUR,2006,Educational Standard - Graduate,2,0,2,6,0,6,0,0,0,0,0,0,8,0,8
MANIPUR,2006,Educational Standard - Post-Graduate,0,0,0,0,0,0,0,0,0,0,0,0,0,0,0
MANIPUR,2006,Educational Standard - Holding technical degree/diploma etc,1,0,1,0,0,0,0,0,0,0,0,0,1,0,1
MANIPUR,2007,Educational Standard,56,0,56,246,6,252,132,4,136,0,0,0,434,10,444
MANIPUR,2007,Educational Standard - Illiterate,3,0,3,50,0,50,6,0,6,0,0,0,59,0,59
MANIPUR,2007,Educational Standard - Below Class X,47,0,47,146,6,152,81,3,84,0,0,0,274,9,283
MANIPUR,2007,Educational Standard - Class X and above but below graduate,3,0,3,27,0,27,34,0,34,0,0,0,64,0,64
MANIPUR,2007,Educational Standard - Graduate,2,0,2,11,0,11,8,1,9,0,0,0,21,1,22
MANIPUR,2007,Educational Standard - Post-Graduate,0,0,0,7,0,7,1,0,1,0,0,0,8,0,8
MANIPUR,2007,Educational Standard - Holding technical degree/diploma etc,1,0,1,5,0,5,2,0,2,0,0,0,8,0,8
MANIPUR,2008,Educational Standard,36,0,36,252,17,269,150,10,160,0,0,0,438,27,465
MANIPUR,2008,Educational Standard - Illiterate,4,0,4,35,3,38,6,2,8,0,0,0,45,5,50
MANIPUR,2008,Educational Standard - Below Class X,27,0,27,118,14,132,136,8,144,0,0,0,281,22,303
MANIPUR,2008,Educational Standard - Class X and above but below graduate,1,0,1,63,0,63,8,0,8,0,0,0,72,0,72
MANIPUR,2008,Educational Standard - Graduate,3,0,3,25,0,25,0,0,0,0,0,0,28,0,28
MANIPUR,2008,Educational Standard - Post-Graduate,0,0,0,7,0,7,0,0,0,0,0,0,7,0,7
MANIPUR,2008,Educational Standard - Holding technical degree/diploma etc,1,0,1,4,0,4,0,0,0,0,0,0,5,0,5
MANIPUR,2009,Educational Standard,34,0,34,323,32,355,127,16,143,0,0,0,484,48,532
MANIPUR,2009,Educational Standard - Illiterate,8,0,8,40,14,54,3,6,9,0,0,0,51,20,71
MANIPUR,2009,Educational Standard - Below Class X,24,0,24,191,16,207,124,2,126,0,0,0,339,18,357
MANIPUR,2009,Educational Standard - Class X and above but below graduate,1,0,1,59,0,59,0,6,6,0,0,0,60,6,66
MANIPUR,2009,Educational Standard - Graduate,1,0,1,20,1,21,0,2,2,0,0,0,21,3,24
MANIPUR,2009,Educational Standard - Post-Graduate,0,0,0,8,1,9,0,0,0,0,0,0,8,1,9
MANIPUR,2009,Educational Standard - Holding technical degree/diploma etc,0,0,0,5,0,5,0,0,0,0,0,0,5,0,5
MANIPUR,2010,Educational Standard,31,1,32,363,10,373,185,28,213,0,0,0,579,39,618
MANIPUR,2010,Educational Standard - Illiterate,8,1,9,25,3,28,19,8,27,0,0,0,52,12,64
MANIPUR,2010,Educational Standard - Below Class X,21,0,21,227,3,230,77,15,92,0,0,0,325,18,343
MANIPUR,2010,Educational Standard - Class X and above but below graduate,1,0,1,75,3,78,69,5,74,0,0,0,145,8,153
MANIPUR,2010,Educational Standard - Graduate,1,0,1,20,1,21,14,0,14,0,0,0,35,1,36
MANIPUR,2010,Educational Standard - Post-Graduate,0,0,0,7,0,7,2,0,2,0,0,0,9,0,9
MANIPUR,2010,Educational Standard - Holding technical degree/diploma etc,0,0,0,9,0,9,4,0,4,0,0,0,13,0,13
MANIPUR,2011,Educational Standard,31,1,32,428,26,454,149,12,161,0,0,0,608,39,647
MANIPUR,2011,Educational Standard - Illiterate,0,1,1,25,8,33,11,2,13,0,0,0,36,11,47
MANIPUR,2011,Educational Standard - Below Class X,29,0,29,294,13,307,66,6,72,0,0,0,389,19,408
MANIPUR,2011,Educational Standard - Class X and above but below graduate,1,0,1,70,3,73,59,2,61,0,0,0,130,5,135
MANIPUR,2011,Educational Standard - Graduate,1,0,1,25,2,27,12,2,14,0,0,0,38,4,42
MANIPUR,2011,Educational Standard - Post-Graduate,0,0,0,7,0,7,1,0,1,0,0,0,8,0,8
MANIPUR,2011,Educational Standard - Holding technical degree/diploma etc,0,0,0,7,0,7,0,0,0,0,0,0,7,0,7
MANIPUR,2012,Educational Standard,63,1,64,506,21,527,121,11,132,0,0,0,690,33,723
MANIPUR,2012,Educational Standard - Illiterate,14,1,15,45,8,53,9,1,10,0,0,0,68,10,78
MANIPUR,2012,Educational Standard - Below Class X,45,0,45,353,8,361,70,9,79,0,0,0,468,17,485
MANIPUR,2012,Educational Standard - Class X and above but below graduate,3,0,3,75,5,80,25,0,25,0,0,0,103,5,108
MANIPUR,2012,Educational Standard - Graduate,1,0,1,20,0,20,15,1,16,0,0,0,36,1,37
MANIPUR,2012,Educational Standard - Post-Graduate,0,0,0,8,0,8,2,0,2,0,0,0,10,0,10
MANIPUR,2012,Educational Standard - Holding technical degree/diploma etc,0,0,0,5,0,5,0,0,0,0,0,0,5,0,5
MEGHALAYA,2001,Educational Standard,14,0,14,497,8,505,7,0,7,0,0,0,518,8,526
MEGHALAYA,2001,Educational Standard - Illiterate,7,0,7,231,5,236,2,0,2,0,0,0,240,5,245
MEGHALAYA,2001,Educational Standard - Below Class X,7,0,7,228,3,231,4,0,4,0,0,0,239,3,242
MEGHALAYA,2001,Educational Standard - Class X and above but below graduate,0,0,0,34,0,34,1,0,1,0,0,0,35,0,35
MEGHALAYA,2001,Educational Standard - Graduate,0,0,0,4,0,4,0,0,0,0,0,0,4,0,4
MEGHALAYA,2001,Educational Standard - Post-Graduate,0,0,0,0,0,0,0,0,0,0,0,0,0,0,0
MEGHALAYA,2001,Educational Standard - Holding technical degree/diploma etc,0,0,0,0,0,0,0,0,0,0,0,0,0,0,0
MEGHALAYA,2002,Educational Standard,20,0,20,495,11,506,6,0,6,0,0,0,521,11,532
MEGHALAYA,2002,Educational Standard - Illiterate,18,0,18,285,6,291,1,0,1,0,0,0,304,6,310
MEGHALAYA,2002,Educational Standard - Below Class X,1,0,1,173,5,178,4,0,4,0,0,0,178,5,183
MEGHALAYA,2002,Educational Standard - Class X and above but below graduate,1,0,1,29,0,29,0,0,0,0,0,0,30,0,30
MEGHALAYA,2002,Educational Standard - Graduate,0,0,0,7,0,7,1,0,1,0,0,0,8,0,8
MEGHALAYA,2002,Educational Standard - Post-Graduate,0,0,0,0,0,0,0,0,0,0,0,0,0,0,0
MEGHALAYA,2002,Educational Standard - Holding technical degree/diploma etc,0,0,0,1,0,1,0,0,0,0,0,0,1,0,1
MEGHALAYA,2003,Educational Standard,39,0,39,500,8,508,8,0,8,0,0,0,547,8,555
MEGHALAYA,2003,Educational Standard - Illiterate,28,0,28,264,5,269,0,0,0,0,0,0,292,5,297
MEGHALAYA,2003,Educational Standard - Below Class X,11,0,11,159,2,161,3,0,3,0,0,0,173,2,175
MEGHALAYA,2003,Educational Standard - Class X and above but below graduate,0,0,0,62,0,62,3,0,3,0,0,0,65,0,65
MEGHALAYA,2003,Educational Standard - Graduate,0,0,0,12,1,13,2,0,2,0,0,0,14,1,15
MEGHALAYA,2003,Educational Standard - Post-Graduate,0,0,0,0,0,0,0,0,0,0,0,0,0,0,0
MEGHALAYA,2003,Educational Standard - Holding technical degree/diploma etc,0,0,0,3,0,3,0,0,0,0,0,0,3,0,3
MEGHALAYA,2004,Educational Standard,41,0,41,420,10,430,22,0,22,0,0,0,483,10,493
MEGHALAYA,2004,Educational Standard - Illiterate,21,0,21,180,3,183,1,0,1,0,0,0,202,3,205
MEGHALAYA,2004,Educational Standard - Below Class X,18,0,18,205,4,209,15,0,15,0,0,0,238,4,242
MEGHALAYA,2004,Educational Standard - Class X and above but below graduate,2,0,2,29,3,32,5,0,5,0,0,0,36,3,39
MEGHALAYA,2004,Educational Standard - Graduate,0,0,0,6,0,6,1,0,1,0,0,0,7,0,7
MEGHALAYA,2004,Educational Standard - Post-Graduate,0,0,0,0,0,0,0,0,0,0,0,0,0,0,0
MEGHALAYA,2004,Educational Standard - Holding technical degree/diploma etc,0,0,0,0,0,0,0,0,0,0,0,0,0,0,0
MEGHALAYA,2005,Educational Standard,42,4,46,478,9,487,22,0,22,0,0,0,542,13,555
MEGHALAYA,2005,Educational Standard - Illiterate,28,0,28,225,5,230,4,0,4,0,0,0,257,5,262
MEGHALAYA,2005,Educational Standard - Below Class X,8,4,12,192,2,194,15,0,15,0,0,0,215,6,221
MEGHALAYA,2005,Educational Standard - Class X and above but below graduate,4,0,4,58,2,60,2,0,2,0,0,0,64,2,66
MEGHALAYA,2005,Educational Standard - Graduate,2,0,2,3,0,3,1,0,1,0,0,0,6,0,6
MEGHALAYA,2005,Educational Standard - Post-Graduate,0,0,0,0,0,0,0,0,0,0,0,0,0,0,0
MEGHALAYA,2005,Educational Standard - Holding technical degree/diploma etc,0,0,0,0,0,0,0,0,0,0,0,0,0,0,0
MEGHALAYA,2006,Educational Standard,56,2,58,532,7,539,24,0,24,0,0,0,612,9,621
MEGHALAYA,2006,Educational Standard - Illiterate,25,1,26,173,1,174,4,0,4,0,0,0,202,2,204
MEGHALAYA,2006,Educational Standard - Below Class X,23,0,23,299,6,305,16,0,16,0,0,0,338,6,344
MEGHALAYA,2006,Educational Standard - Class X and above but below graduate,2,1,3,42,0,42,4,0,4,0,0,0,48,1,49
MEGHALAYA,2006,Educational Standard - Graduate,5,0,5,18,0,18,0,0,0,0,0,0,23,0,23
MEGHALAYA,2006,Educational Standard - Post-Graduate,1,0,1,0,0,0,0,0,0,0,0,0,1,0,1
MEGHALAYA,2006,Educational Standard - Holding technical degree/diploma etc,0,0,0,0,0,0,0,0,0,0,0,0,0,0,0
MEGHALAYA,2007,Educational Standard,70,2,72,553,4,557,36,0,36,0,0,0,659,6,665
MEGHALAYA,2007,Educational Standard - Illiterate,12,1,13,275,1,276,6,0,6,0,0,0,293,2,295
MEGHALAYA,2007,Educational Standard - Below Class X,11,0,11,202,3,205,22,0,22,0,0,0,235,3,238
MEGHALAYA,2007,Educational Standard - Class X and above but below graduate,43,1,44,75,0,75,8,0,8,0,0,0,126,1,127
MEGHALAYA,2007,Educational Standard - Graduate,3,0,3,1,0,1,0,0,0,0,0,0,4,0,4
MEGHALAYA,2007,Educational Standard - Post-Graduate,1,0,1,0,0,0,0,0,0,0,0,0,1,0,1
MEGHALAYA,2007,Educational Standard - Holding technical degree/diploma etc,0,0,0,0,0,0,0,0,0,0,0,0,0,0,0
MEGHALAYA,2008,Educational Standard,90,2,92,476,4,480,47,0,47,0,0,0,613,6,619
MEGHALAYA,2008,Educational Standard - Illiterate,37,2,39,249,3,252,9,0,9,0,0,0,295,5,300
MEGHALAYA,2008,Educational Standard - Below Class X,41,0,41,197,1,198,32,0,32,0,0,0,270,1,271
MEGHALAYA,2008,Educational Standard - Class X and above but below graduate,8,0,8,30,0,30,6,0,6,0,0,0,44,0,44
MEGHALAYA,2008,Educational Standard - Graduate,3,0,3,0,0,0,0,0,0,0,0,0,3,0,3
MEGHALAYA,2008,Educational Standard - Post-Graduate,1,0,1,0,0,0,0,0,0,0,0,0,1,0,1
MEGHALAYA,2008,Educational Standard - Holding technical degree/diploma etc,0,0,0,0,0,0,0,0,0,0,0,0,0,0,0
MEGHALAYA,2009,Educational Standard,97,1,98,513,7,520,38,0,38,0,0,0,648,8,656
MEGHALAYA,2009,Educational Standard - Illiterate,31,1,32,197,3,200,4,0,4,0,0,0,232,4,236
MEGHALAYA,2009,Educational Standard - Below Class X,40,0,40,247,4,251,10,0,10,0,0,0,297,4,301
MEGHALAYA,2009,Educational Standard - Class X and above but below graduate,16,0,16,62,0,62,19,0,19,0,0,0,97,0,97
MEGHALAYA,2009,Educational Standard - Graduate,9,0,9,7,0,7,5,0,5,0,0,0,21,0,21
MEGHALAYA,2009,Educational Standard - Post-Graduate,1,0,1,0,0,0,0,0,0,0,0,0,1,0,1
MEGHALAYA,2009,Educational Standard - Holding technical degree/diploma etc,0,0,0,0,0,0,0,0,0,0,0,0,0,0,0
MEGHALAYA,2010,Educational Standard,70,0,70,507,6,513,43,0,43,0,0,0,620,6,626
MEGHALAYA,2010,Educational Standard - Illiterate,30,0,30,209,3,212,23,0,23,0,0,0,262,3,265
MEGHALAYA,2010,Educational Standard - Below Class X,29,0,29,221,3,224,19,0,19,0,0,0,269,3,272
MEGHALAYA,2010,Educational Standard - Class X and above but below graduate,11,0,11,77,0,77,0,0,0,0,0,0,88,0,88
MEGHALAYA,2010,Educational Standard - Graduate,0,0,0,0,0,0,1,0,1,0,0,0,1,0,1
MEGHALAYA,2010,Educational Standard - Post-Graduate,0,0,0,0,0,0,0,0,0,0,0,0,0,0,0
MEGHALAYA,2010,Educational Standard - Holding technical degree/diploma etc,0,0,0,0,0,0,0,0,0,0,0,0,0,0,0
MEGHALAYA,2011,Educational Standard,65,0,65,466,12,478,27,0,27,0,0,0,558,12,570
MEGHALAYA,2011,Educational Standard - Illiterate,18,0,18,198,1,199,7,0,7,0,0,0,223,1,224
MEGHALAYA,2011,Educational Standard - Below Class X,20,0,20,216,11,227,17,0,17,0,0,0,253,11,264
MEGHALAYA,2011,Educational Standard - Class X and above but below graduate,26,0,26,51,0,51,1,0,1,0,0,0,78,0,78
MEGHALAYA,2011,Educational Standard - Graduate,1,0,1,1,0,1,1,0,1,0,0,0,3,0,3
MEGHALAYA,2011,Educational Standard - Post-Graduate,0,0,0,0,0,0,1,0,1,0,0,0,1,0,1
MEGHALAYA,2011,Educational Standard - Holding technical degree/diploma etc,0,0,0,0,0,0,0,0,0,0,0,0,0,0,0
MEGHALAYA,2012,Educational Standard,70,0,70,593,12,605,21,0,21,0,0,0,684,12,696
MEGHALAYA,2012,Educational Standard - Illiterate,11,0,11,209,7,216,3,0,3,0,0,0,223,7,230
MEGHALAYA,2012,Educational Standard - Below Class X,52,0,52,290,5,295,15,0,15,0,0,0,357,5,362
MEGHALAYA,2012,Educational Standard - Class X and above but below graduate,7,0,7,87,0,87,2,0,2,0,0,0,96,0,96
MEGHALAYA,2012,Educational Standard - Graduate,0,0,0,6,0,6,1,0,1,0,0,0,7,0,7
MEGHALAYA,2012,Educational Standard - Post-Graduate,0,0,0,1,0,1,0,0,0,0,0,0,1,0,1
MEGHALAYA,2012,Educational Standard - Holding technical degree/diploma etc,0,0,0,0,0,0,0,0,0,0,0,0,0,0,0
MIZORAM,2001,Educational Standard,143,11,154,632,72,704,0,0,0,0,0,0,775,83,858
MIZORAM,2001,Educational Standard - Illiterate,12,1,13,54,8,62,0,0,0,0,0,0,66,9,75
MIZORAM,2001,Educational Standard - Below Class X,117,10,127,532,64,596,0,0,0,0,0,0,649,74,723
MIZORAM,2001,Educational Standard - Class X and above but below graduate,14,0,14,45,0,45,0,0,0,0,0,0,59,0,59
MIZORAM,2001,Educational Standard - Graduate,0,0,0,1,0,1,0,0,0,0,0,0,1,0,1
MIZORAM,2001,Educational Standard - Post-Graduate,0,0,0,0,0,0,0,0,0,0,0,0,0,0,0
MIZORAM,2001,Educational Standard - Holding technical degree/diploma etc,0,0,0,0,0,0,0,0,0,0,0,0,0,0,0
MIZORAM,2002,Educational Standard,256,21,277,516,65,581,0,0,0,0,0,0,772,86,858
MIZORAM,2002,Educational Standard - Illiterate,9,2,11,63,9,72,0,0,0,0,0,0,72,11,83
MIZORAM,2002,Educational Standard - Below Class X,229,6,235,370,47,417,0,0,0,0,0,0,599,53,652
MIZORAM,2002,Educational Standard - Class X and above but below graduate,18,13,31,80,9,89,0,0,0,0,0,0,98,22,120
MIZORAM,2002,Educational Standard - Graduate,0,0,0,3,0,3,0,0,0,0,0,0,3,0,3
MIZORAM,2002,Educational Standard - Post-Graduate,0,0,0,0,0,0,0,0,0,0,0,0,0,0,0
MIZORAM,2002,Educational Standard - Holding technical degree/diploma etc,0,0,0,0,0,0,0,0,0,0,0,0,0,0,0
MIZORAM,2003,Educational Standard,194,8,202,567,68,635,0,0,0,0,0,0,761,76,837
MIZORAM,2003,Educational Standard - Illiterate,3,0,3,18,8,26,0,0,0,0,0,0,21,8,29
MIZORAM,2003,Educational Standard - Below Class X,167,8,175,480,59,539,0,0,0,0,0,0,647,67,714
MIZORAM,2003,Educational Standard - Class X and above but below graduate,23,0,23,65,1,66,0,0,0,0,0,0,88,1,89
MIZORAM,2003,Educational Standard - Graduate,1,0,1,4,0,4,0,0,0,0,0,0,5,0,5
MIZORAM,2003,Educational Standard - Post-Graduate,0,0,0,0,0,0,0,0,0,0,0,0,0,0,0
MIZORAM,2003,Educational Standard - Holding technical degree/diploma etc,0,0,0,0,0,0,0,0,0,0,0,0,0,0,0
MIZORAM,2004,Educational Standard,208,9,217,656,86,742,0,0,0,0,0,0,864,95,959
MIZORAM,2004,Educational Standard - Illiterate,24,1,25,57,6,63,0,0,0,0,0,0,81,7,88
MIZORAM,2004,Educational Standard - Below Class X,167,8,175,584,80,664,0,0,0,0,0,0,751,88,839
MIZORAM,2004,Educational Standard - Class X and above but below graduate,12,0,12,0,0,0,0,0,0,0,0,0,12,0,12
MIZORAM,2004,Educational Standard - Graduate,5,0,5,15,0,15,0,0,0,0,0,0,20,0,20
MIZORAM,2004,Educational Standard - Post-Graduate,0,0,0,0,0,0,0,0,0,0,0,0,0,0,0
MIZORAM,2004,Educational Standard - Holding technical degree/diploma etc,0,0,0,0,0,0,0,0,0,0,0,0,0,0,0
MIZORAM,2005,Educational Standard,151,20,171,483,59,542,0,0,0,0,0,0,634,79,713
MIZORAM,2005,Educational Standard - Illiterate,7,3,10,11,15,26,0,0,0,0,0,0,18,18,36
MIZORAM,2005,Educational Standard - Below Class X,125,2,127,412,31,443,0,0,0,0,0,0,537,33,570
MIZORAM,2005,Educational Standard - Class X and above but below graduate,17,15,32,54,13,67,0,0,0,0,0,0,71,28,99
MIZORAM,2005,Educational Standard - Graduate,2,0,2,6,0,6,0,0,0,0,0,0,8,0,8
MIZORAM,2005,Educational Standard - Post-Graduate,0,0,0,0,0,0,0,0,0,0,0,0,0,0,0
MIZORAM,2005,Educational Standard - Holding technical degree/diploma etc,0,0,0,0,0,0,0,0,0,0,0,0,0,0,0
MIZORAM,2006,Educational Standard,196,17,213,453,63,516,0,0,0,0,0,0,649,80,729
MIZORAM,2006,Educational Standard - Illiterate,15,5,20,43,15,58,0,0,0,0,0,0,58,20,78
MIZORAM,2006,Educational Standard - Below Class X,149,8,157,370,40,410,0,0,0,0,0,0,519,48,567
MIZORAM,2006,Educational Standard - Class X and above but below graduate,28,3,31,40,8,48,0,0,0,0,0,0,68,11,79
MIZORAM,2006,Educational Standard - Graduate,4,1,5,0,0,0,0,0,0,0,0,0,4,1,5
MIZORAM,2006,Educational Standard - Post-Graduate,0,0,0,0,0,0,0,0,0,0,0,0,0,0,0
MIZORAM,2006,Educational Standard - Holding technical degree/diploma etc,0,0,0,0,0,0,0,0,0,0,0,0,0,0,0
MIZORAM,2007,Educational Standard,284,22,306,562,73,635,0,0,0,0,0,0,846,95,941
MIZORAM,2007,Educational Standard - Illiterate,24,3,27,25,7,32,0,0,0,0,0,0,49,10,59
MIZORAM,2007,Educational Standard - Below Class X,167,16,183,349,62,411,0,0,0,0,0,0,516,78,594
MIZORAM,2007,Educational Standard - Class X and above but below graduate,81,3,84,172,3,175,0,0,0,0,0,0,253,6,259
MIZORAM,2007,Educational Standard - Graduate,2,0,2,4,1,5,0,0,0,0,0,0,6,1,7
MIZORAM,2007,Educational Standard - Post-Graduate,0,0,0,1,0,1,0,0,0,0,0,0,1,0,1
MIZORAM,2007,Educational Standard - Holding technical degree/diploma etc,10,0,10,11,0,11,0,0,0,0,0,0,21,0,21
MIZORAM,2008,Educational Standard,314,15,329,414,47,461,0,0,0,0,0,0,728,62,790
MIZORAM,2008,Educational Standard - Illiterate,13,1,14,44,1,45,0,0,0,0,0,0,57,2,59
MIZORAM,2008,Educational Standard - Below Class X,187,12,199,267,44,311,0,0,0,0,0,0,454,56,510
MIZORAM,2008,Educational Standard - Class X and above but below graduate,99,1,100,89,1,90,0,0,0,0,0,0,188,2,190
MIZORAM,2008,Educational Standard - Graduate,4,1,5,5,1,6,0,0,0,0,0,0,9,2,11
MIZORAM,2008,Educational Standard - Post-Graduate,11,0,11,9,0,9,0,0,0,0,0,0,20,0,20
MIZORAM,2008,Educational Standard - Holding technical degree/diploma etc,0,0,0,0,0,0,0,0,0,0,0,0,0,0,0
MIZORAM,2009,Educational Standard,342,11,353,367,45,412,0,0,0,0,0,0,709,56,765
MIZORAM,2009,Educational Standard - Illiterate,37,3,40,28,7,35,0,0,0,0,0,0,65,10,75
MIZORAM,2009,Educational Standard - Below Class X,142,4,146,271,21,292,0,0,0,0,0,0,413,25,438
MIZORAM,2009,Educational Standard - Class X and above but below graduate,159,4,163,62,10,72,0,0,0,0,0,0,221,14,235
MIZORAM,2009,Educational Standard - Graduate,4,0,4,6,7,13,0,0,0,0,0,0,10,7,17
MIZORAM,2009,Educational Standard - Post-Graduate,0,0,0,0,0,0,0,0,0,0,0,0,0,0,0
MIZORAM,2009,Educational Standard - Holding technical degree/diploma etc,0,0,0,0,0,0,0,0,0,0,0,0,0,0,0
MIZORAM,2010,Educational Standard,430,21,451,481,60,541,0,0,0,0,0,0,911,81,992
MIZORAM,2010,Educational Standard - Illiterate,16,0,16,23,3,26,0,0,0,0,0,0,39,3,42
MIZORAM,2010,Educational Standard - Below Class X,197,20,217,232,50,282,0,0,0,0,0,0,429,70,499
MIZORAM,2010,Educational Standard - Class X and above but below graduate,196,1,197,220,5,225,0,0,0,0,0,0,416,6,422
MIZORAM,2010,Educational Standard - Graduate,21,0,21,6,2,8,0,0,0,0,0,0,27,2,29
MIZORAM,2010,Educational Standard - Post-Graduate,0,0,0,0,0,0,0,0,0,0,0,0,0,0,0
MIZORAM,2010,Educational Standard - Holding technical degree/diploma etc,0,0,0,0,0,0,0,0,0,0,0,0,0,0,0
MIZORAM,2011,Educational Standard,362,20,382,447,52,499,0,0,0,0,0,0,809,72,881
MIZORAM,2011,Educational Standard - Illiterate,25,0,25,33,9,42,0,0,0,0,0,0,58,9,67
MIZORAM,2011,Educational Standard - Below Class X,292,17,309,352,30,382,0,0,0,0,0,0,644,47,691
MIZORAM,2011,Educational Standard - Class X and above but below graduate,37,3,40,53,12,65,0,0,0,0,0,0,90,15,105
MIZORAM,2011,Educational Standard - Graduate,8,0,8,9,1,10,0,0,0,0,0,0,17,1,18
MIZORAM,2011,Educational Standard - Post-Graduate,0,0,0,0,0,0,0,0,0,0,0,0,0,0,0
MIZORAM,2011,Educational Standard - Holding technical degree/diploma etc,0,0,0,0,0,0,0,0,0,0,0,0,0,0,0
MIZORAM,2012,Educational Standard,310,9,319,475,53,528,0,0,0,0,0,0,785,62,847
MIZORAM,2012,Educational Standard - Illiterate,21,0,21,27,6,33,0,0,0,0,0,0,48,6,54
MIZORAM,2012,Educational Standard - Below Class X,245,9,254,375,43,418,0,0,0,0,0,0,620,52,672
MIZORAM,2012,Educational Standard - Class X and above but below graduate,39,0,39,67,4,71,0,0,0,0,0,0,106,4,110
MIZORAM,2012,Educational Standard - Graduate,4,0,4,6,0,6,0,0,0,0,0,0,10,0,10
MIZORAM,2012,Educational Standard - Post-Graduate,1,0,1,0,0,0,0,0,0,0,0,0,1,0,1
MIZORAM,2012,Educational Standard - Holding technical degree/diploma etc,0,0,0,0,0,0,0,0,0,0,0,0,0,0,0
NAGALAND,2001,Educational Standard,66,2,68,527,18,545,52,0,52,0,0,0,645,20,665
NAGALAND,2001,Educational Standard - Illiterate,1,1,2,38,9,47,0,0,0,0,0,0,39,10,49
NAGALAND,2001,Educational Standard - Below Class X,21,1,22,217,5,222,17,0,17,0,0,0,255,6,261
NAGALAND,2001,Educational Standard - Class X and above but below graduate,31,0,31,252,4,256,32,0,32,0,0,0,315,4,319
NAGALAND,2001,Educational Standard - Graduate,11,0,11,19,0,19,2,0,2,0,0,0,32,0,32
NAGALAND,2001,Educational Standard - Post-Graduate,2,0,2,1,0,1,1,0,1,0,0,0,4,0,4
NAGALAND,2001,Educational Standard - Holding technical degree/diploma etc,0,0,0,0,0,0,0,0,0,0,0,0,0,0,0
NAGALAND,2002,Educational Standard,29,1,30,533,11,544,57,0,57,0,0,0,619,12,631
NAGALAND,2002,Educational Standard - Illiterate,0,0,0,47,2,49,0,0,0,0,0,0,47,2,49
NAGALAND,2002,Educational Standard - Below Class X,7,1,8,321,9,330,20,0,20,0,0,0,348,10,358
NAGALAND,2002,Educational Standard - Class X and above but below graduate,18,0,18,163,0,163,32,0,32,0,0,0,213,0,213
NAGALAND,2002,Educational Standard - Graduate,4,0,4,1,0,1,4,0,4,0,0,0,9,0,9
NAGALAND,2002,Educational Standard - Post-Graduate,0,0,0,1,0,1,1,0,1,0,0,0,2,0,2
NAGALAND,2002,Educational Standard - Holding technical degree/diploma etc,0,0,0,0,0,0,0,0,0,0,0,0,0,0,0
NAGALAND,2003,Educational Standard,88,1,89,394,13,407,72,0,72,0,0,0,554,14,568
NAGALAND,2003,Educational Standard - Illiterate,0,0,0,21,4,25,0,0,0,0,0,0,21,4,25
NAGALAND,2003,Educational Standard - Below Class X,23,0,23,161,3,164,14,0,14,0,0,0,198,3,201
NAGALAND,2003,Educational Standard - Class X and above but below graduate,57,1,58,208,6,214,49,0,49,0,0,0,314,7,321
NAGALAND,2003,Educational Standard - Graduate,8,0,8,4,0,4,8,0,8,0,0,0,20,0,20
NAGALAND,2003,Educational Standard - Post-Graduate,0,0,0,0,0,0,1,0,1,0,0,0,1,0,1
NAGALAND,2003,Educational Standard - Holding technical degree/diploma etc,0,0,0,0,0,0,0,0,0,0,0,0,0,0,0
NAGALAND,2004,Educational Standard,160,1,161,374,16,390,38,0,38,0,0,0,572,17,589
NAGALAND,2004,Educational Standard - Illiterate,11,0,11,29,4,33,2,0,2,0,0,0,42,4,46
NAGALAND,2004,Educational Standard - Below Class X,77,1,78,160,10,170,13,0,13,0,0,0,250,11,261
NAGALAND,2004,Educational Standard - Class X and above but below graduate,62,0,62,180,2,182,21,0,21,0,0,0,263,2,265
NAGALAND,2004,Educational Standard - Graduate,10,0,10,4,0,4,2,0,2,0,0,0,16,0,16
NAGALAND,2004,Educational Standard - Post-Graduate,0,0,0,1,0,1,0,0,0,0,0,0,1,0,1
NAGALAND,2004,Educational Standard - Holding technical degree/diploma etc,0,0,0,0,0,0,0,0,0,0,0,0,0,0,0
NAGALAND,2005,Educational Standard,113,4,117,468,16,484,24,0,24,0,0,0,605,20,625
NAGALAND,2005,Educational Standard - Illiterate,11,0,11,47,8,55,0,0,0,0,0,0,58,8,66
NAGALAND,2005,Educational Standard - Below Class X,70,2,72,211,5,216,5,0,5,0,0,0,286,7,293
NAGALAND,2005,Educational Standard - Class X and above but below graduate,27,2,29,200,3,203,12,0,12,0,0,0,239,5,244
NAGALAND,2005,Educational Standard - Graduate,5,0,5,10,0,10,7,0,7,0,0,0,22,0,22
NAGALAND,2005,Educational Standard - Post-Graduate,0,0,0,0,0,0,0,0,0,0,0,0,0,0,0
NAGALAND,2005,Educational Standard - Holding technical degree/diploma etc,0,0,0,0,0,0,0,0,0,0,0,0,0,0,0
NAGALAND,2006,Educational Standard,127,6,133,498,19,517,21,3,24,0,0,0,646,28,674
NAGALAND,2006,Educational Standard - Illiterate,7,1,8,68,7,75,0,0,0,0,0,0,75,8,83
NAGALAND,2006,Educational Standard - Below Class X,65,4,69,203,10,213,2,2,4,0,0,0,270,16,286
NAGALAND,2006,Educational Standard - Class X and above but below graduate,47,1,48,172,2,174,15,1,16,0,0,0,234,4,238
NAGALAND,2006,Educational Standard - Graduate,6,0,6,47,0,47,3,0,3,0,0,0,56,0,56
NAGALAND,2006,Educational Standard - Post-Graduate,2,0,2,8,0,8,1,0,1,0,0,0,11,0,11
NAGALAND,2006,Educational Standard - Holding technical degree/diploma etc,0,0,0,0,0,0,0,0,0,0,0,0,0,0,0
NAGALAND,2007,Educational Standard,95,6,101,382,12,394,6,0,6,0,0,0,483,18,501
NAGALAND,2007,Educational Standard - Illiterate,20,1,21,57,3,60,0,0,0,0,0,0,77,4,81
NAGALAND,2007,Educational Standard - Below Class X,40,2,42,181,4,185,1,0,1,0,0,0,222,6,228
NAGALAND,2007,Educational Standard - Class X and above but below graduate,31,3,34,112,5,117,5,0,5,0,0,0,148,8,156
NAGALAND,2007,Educational Standard - Graduate,4,0,4,30,0,30,0,0,0,0,0,0,34,0,34
NAGALAND,2007,Educational Standard - Post-Graduate,0,0,0,2,0,2,0,0,0,0,0,0,2,0,2
NAGALAND,2007,Educational Standard - Holding technical degree/diploma etc,0,0,0,0,0,0,0,0,0,0,0,0,0,0,0
NAGALAND,2008,Educational Standard,154,6,160,386,10,396,63,0,63,0,0,0,603,16,619
NAGALAND,2008,Educational Standard - Illiterate,27,0,27,112,4,116,11,0,11,0,0,0,150,4,154
NAGALAND,2008,Educational Standard - Below Class X,102,6,108,206,5,211,9,0,9,0,0,0,317,11,328
NAGALAND,2008,Educational Standard - Class X and above but below graduate,25,0,25,64,1,65,35,0,35,0,0,0,124,1,125
NAGALAND,2008,Educational Standard - Graduate,0,0,0,4,0,4,7,0,7,0,0,0,11,0,11
NAGALAND,2008,Educational Standard - Post-Graduate,0,0,0,0,0,0,1,0,1,0,0,0,1,0,1
NAGALAND,2008,Educational Standard - Holding technical degree/diploma etc,0,0,0,0,0,0,0,0,0,0,0,0,0,0,0
NAGALAND,2009,Educational Standard,152,2,154,412,15,427,42,0,42,0,0,0,606,17,623
NAGALAND,2009,Educational Standard - Illiterate,36,0,36,63,6,69,0,0,0,0,0,0,99,6,105
NAGALAND,2009,Educational Standard - Below Class X,59,2,61,207,7,214,27,0,27,0,0,0,293,9,302
NAGALAND,2009,Educational Standard - Class X and above but below graduate,49,0,49,110,2,112,15,0,15,0,0,0,174,2,176
NAGALAND,2009,Educational Standard - Graduate,8,0,8,31,0,31,0,0,0,0,0,0,39,0,39
NAGALAND,2009,Educational Standard - Post-Graduate,0,0,0,1,0,1,0,0,0,0,0,0,1,0,1
NAGALAND,2009,Educational Standard - Holding technical degree/diploma etc,0,0,0,0,0,0,0,0,0,0,0,0,0,0,0
NAGALAND,2010,Educational Standard,159,4,163,311,14,325,33,0,33,0,0,0,503,18,521
NAGALAND,2010,Educational Standard - Illiterate,25,0,25,30,2,32,0,0,0,0,0,0,55,2,57
NAGALAND,2010,Educational Standard - Below Class X,64,4,68,170,5,175,20,0,20,0,0,0,254,9,263
NAGALAND,2010,Educational Standard - Class X and above but below graduate,60,0,60,95,7,102,13,0,13,0,0,0,168,7,175
NAGALAND,2010,Educational Standard - Graduate,10,0,10,16,0,16,0,0,0,0,0,0,26,0,26
NAGALAND,2010,Educational Standard - Post-Graduate,0,0,0,0,0,0,0,0,0,0,0,0,0,0,0
NAGALAND,2010,Educational Standard - Holding technical degree/diploma etc,0,0,0,0,0,0,0,0,0,0,0,0,0,0,0
NAGALAND,2011,Educational Standard,123,7,130,291,8,299,72,1,73,0,0,0,486,16,502
NAGALAND,2011,Educational Standard - Illiterate,11,0,11,26,4,30,7,0,7,0,0,0,44,4,48
NAGALAND,2011,Educational Standard - Below Class X,104,7,111,234,4,238,56,1,57,0,0,0,394,12,406
NAGALAND,2011,Educational Standard - Class X and above but below graduate,7,0,7,24,0,24,7,0,7,0,0,0,38,0,38
NAGALAND,2011,Educational Standard - Graduate,1,0,1,4,0,4,2,0,2,0,0,0,7,0,7
NAGALAND,2011,Educational Standard - Post-Graduate,0,0,0,2,0,2,0,0,0,0,0,0,2,0,2
NAGALAND,2011,Educational Standard - Holding technical degree/diploma etc,0,0,0,1,0,1,0,0,0,0,0,0,1,0,1
NAGALAND,2012,Educational Standard,120,5,125,243,10,253,18,1,19,1,0,1,382,16,398
NAGALAND,2012,Educational Standard - Illiterate,28,0,28,40,5,45,8,0,8,1,0,1,77,5,82
NAGALAND,2012,Educational Standard - Below Class X,81,5,86,176,5,181,10,1,11,0,0,0,267,11,278
NAGALAND,2012,Educational Standard - Class X and above but below graduate,9,0,9,23,0,23,0,0,0,0,0,0,32,0,32
NAGALAND,2012,Educational Standard - Graduate,2,0,2,0,0,0,0,0,0,0,0,0,2,0,2
NAGALAND,2012,Educational Standard - Post-Graduate,0,0,0,1,0,1,0,0,0,0,0,0,1,0,1
NAGALAND,2012,Educational Standard - Holding technical degree/diploma etc,0,0,0,3,0,3,0,0,0,0,0,0,3,0,3
ORISSA,2001,Educational Standard,2764,52,2816,8519,249,8768,45,0,45,46,0,46,11374,301,11675
ORISSA,2001,Educational Standard - Illiterate,830,12,842,3355,143,3498,0,0,0,0,0,0,4185,155,4340
ORISSA,2001,Educational Standard - Below Class X,1246,38,1284,3900,98,3998,33,0,33,44,0,44,5223,136,5359
ORISSA,2001,Educational Standard - Class X and above but below graduate,664,0,664,1145,6,1151,11,0,11,2,0,2,1822,6,1828
ORISSA,2001,Educational Standard - Graduate,17,2,19,110,2,112,1,0,1,0,0,0,128,4,132
ORISSA,2001,Educational Standard - Post-Graduate,2,0,2,2,0,2,0,0,0,0,0,0,4,0,4
ORISSA,2001,Educational Standard - Holding technical degree/diploma etc,5,0,5,7,0,7,0,0,0,0,0,0,12,0,12
ORISSA,2002,Educational Standard,2926,49,2975,9324,292,9616,0,0,0,46,0,46,12296,341,12637
ORISSA,2002,Educational Standard - Illiterate,1039,29,1068,3547,152,3699,0,0,0,19,0,19,4605,181,4786
ORISSA,2002,Educational Standard - Below Class X,1649,20,1669,3950,115,4065,0,0,0,18,0,18,5617,135,5752
ORISSA,2002,Educational Standard - Class X and above but below graduate,170,0,170,1674,24,1698,0,0,0,9,0,9,1853,24,1877
ORISSA,2002,Educational Standard - Graduate,58,0,58,132,1,133,0,0,0,0,0,0,190,1,191
ORISSA,2002,Educational Standard - Post-Graduate,7,0,7,7,0,7,0,0,0,0,0,0,14,0,14
ORISSA,2002,Educational Standard - Holding technical degree/diploma etc,3,0,3,14,0,14,0,0,0,0,0,0,17,0,17
ORISSA,2003,Educational Standard,3226,66,3292,9350,290,9640,0,0,0,35,0,35,12611,356,12967
ORISSA,2003,Educational Standard - Illiterate,1109,41,1150,3263,94,3357,0,0,0,21,0,21,4393,135,4528
ORISSA,2003,Educational Standard - Below Class X,1816,25,1841,4153,155,4308,0,0,0,10,0,10,5979,180,6159
ORISSA,2003,Educational Standard - Class X and above but below graduate,211,0,211,1744,38,1782,0,0,0,4,0,4,1959,38,1997
ORISSA,2003,Educational Standard - Graduate,73,0,73,159,3,162,0,0,0,0,0,0,232,3,235
ORISSA,2003,Educational Standard - Post-Graduate,12,0,12,20,0,20,0,0,0,0,0,0,32,0,32
ORISSA,2003,Educational Standard - Holding technical degree/diploma etc,5,0,5,11,0,11,0,0,0,0,0,0,16,0,16
ORISSA,2004,Educational Standard,3615,65,3680,9149,295,9444,9,0,9,24,1,25,12797,361,13158
ORISSA,2004,Educational Standard - Illiterate,995,30,1025,2575,186,2761,3,0,3,0,0,0,3573,216,3789
ORISSA,2004,Educational Standard - Below Class X,2209,31,2240,5283,101,5384,5,0,5,4,0,4,7501,132,7633
ORISSA,2004,Educational Standard - Class X and above but below graduate,387,4,391,1077,8,1085,0,0,0,19,1,20,1483,13,1496
ORISSA,2004,Educational Standard - Graduate,23,0,23,198,0,198,1,0,1,1,0,1,223,0,223
ORISSA,2004,Educational Standard - Post-Graduate,0,0,0,5,0,5,0,0,0,0,0,0,5,0,5
ORISSA,2004,Educational Standard - Holding technical degree/diploma etc,1,0,1,11,0,11,0,0,0,0,0,0,12,0,12
ORISSA,2005,Educational Standard,4108,88,4196,9378,342,9720,15,0,15,27,0,27,13528,430,13958
ORISSA,2005,Educational Standard - Illiterate,888,49,937,2527,146,2673,0,0,0,3,0,3,3418,195,3613
ORISSA,2005,Educational Standard - Below Class X,2707,37,2744,5729,174,5903,14,0,14,21,0,21,8471,211,8682
ORISSA,2005,Educational Standard - Class X and above but below graduate,292,2,294,926,20,946,0,0,0,2,0,2,1220,22,1242
ORISSA,2005,Educational Standard - Graduate,213,0,213,175,2,177,1,0,1,1,0,1,390,2,392
ORISSA,2005,Educational Standard - Post-Graduate,8,0,8,16,0,16,0,0,0,0,0,0,24,0,24
ORISSA,2005,Educational Standard - Holding technical degree/diploma etc,0,0,0,5,0,5,0,0,0,0,0,0,5,0,5
ORISSA,2006,Educational Standard,4274,91,4365,9861,386,10247,0,0,0,31,1,32,14166,478,14644
ORISSA,2006,Educational Standard - Illiterate,732,34,766,2675,122,2797,0,0,0,8,0,8,3415,156,3571
ORISSA,2006,Educational Standard - Below Class X,2786,49,2835,5961,241,6202,0,0,0,19,1,20,8766,291,9057
ORISSA,2006,Educational Standard - Class X and above but below graduate,419,7,426,980,23,1003,0,0,0,4,0,4,1403,30,1433
ORISSA,2006,Educational Standard - Graduate,325,1,326,213,0,213,0,0,0,0,0,0,538,1,539
ORISSA,2006,Educational Standard - Post-Graduate,11,0,11,28,0,28,0,0,0,0,0,0,39,0,39
ORISSA,2006,Educational Standard - Holding technical degree/diploma etc,1,0,1,4,0,4,0,0,0,0,0,0,5,0,5
ORISSA,2007,Educational Standard,4242,103,4345,10503,517,11020,3,0,3,0,0,0,14748,620,15368
ORISSA,2007,Educational Standard - Illiterate,732,34,766,2675,122,2797,3,0,3,0,0,0,3410,156,3566
ORISSA,2007,Educational Standard - Below Class X,2786,61,2847,6591,360,6951,0,0,0,0,0,0,9377,421,9798
ORISSA,2007,Educational Standard - Class X and above but below graduate,405,7,412,992,35,1027,0,0,0,0,0,0,1397,42,1439
ORISSA,2007,Educational Standard - Graduate,307,1,308,213,0,213,0,0,0,0,0,0,520,1,521
ORISSA,2007,Educational Standard - Post-Graduate,11,0,11,28,0,28,0,0,0,0,0,0,39,0,39
ORISSA,2007,Educational Standard - Holding technical degree/diploma etc,1,0,1,4,0,4,0,0,0,0,0,0,5,0,5
ORISSA,2008,Educational Standard,4178,122,4300,9660,401,10061,12,0,12,0,0,0,13850,523,14373
ORISSA,2008,Educational Standard - Illiterate,748,12,760,2514,164,2678,8,0,8,0,0,0,3270,176,3446
ORISSA,2008,Educational Standard - Below Class X,2718,97,2815,5801,216,6017,4,0,4,0,0,0,8523,313,8836
ORISSA,2008,Educational Standard - Class X and above but below graduate,401,12,413,1095,21,1116,0,0,0,0,0,0,1496,33,1529
ORISSA,2008,Educational Standard - Graduate,302,1,303,218,0,218,0,0,0,0,0,0,520,1,521
ORISSA,2008,Educational Standard - Post-Graduate,8,0,8,30,0,30,0,0,0,0,0,0,38,0,38
ORISSA,2008,Educational Standard - Holding technical degree/diploma etc,1,0,1,2,0,2,0,0,0,0,0,0,3,0,3
ORISSA,2009,Educational Standard,3915,108,4023,9120,391,9511,0,0,0,0,0,0,13035,499,13534
ORISSA,2009,Educational Standard - Illiterate,748,10,758,2409,156,2565,0,0,0,0,0,0,3157,166,3323
ORISSA,2009,Educational Standard - Below Class X,2496,87,2583,5348,218,5566,0,0,0,0,0,0,7844,305,8149
ORISSA,2009,Educational Standard - Class X and above but below graduate,388,9,397,1095,17,1112,0,0,0,0,0,0,1483,26,1509
ORISSA,2009,Educational Standard - Graduate,274,2,276,236,0,236,0,0,0,0,0,0,510,2,512
ORISSA,2009,Educational Standard - Post-Graduate,8,0,8,30,0,30,0,0,0,0,0,0,38,0,38
ORISSA,2009,Educational Standard - Holding technical degree/diploma etc,1,0,1,2,0,2,0,0,0,0,0,0,3,0,3
ORISSA,2010,Educational Standard,3837,114,3951,8102,376,8478,0,0,0,0,0,0,11939,490,12429
ORISSA,2010,Educational Standard - Illiterate,645,12,657,2113,141,2254,0,0,0,0,0,0,2758,153,2911
ORISSA,2010,Educational Standard - Below Class X,2802,95,2897,4630,218,4848,0,0,0,0,0,0,7432,313,7745
ORISSA,2010,Educational Standard - Class X and above but below graduate,214,5,219,1095,17,1112,0,0,0,0,0,0,1309,22,1331
ORISSA,2010,Educational Standard - Graduate,169,2,171,232,0,232,0,0,0,0,0,0,401,2,403
ORISSA,2010,Educational Standard - Post-Graduate,6,0,6,30,0,30,0,0,0,0,0,0,36,0,36
ORISSA,2010,Educational Standard - Holding technical degree/diploma etc,1,0,1,2,0,2,0,0,0,0,0,0,3,0,3
ORISSA,2011,Educational Standard,3589,112,3701,8721,331,9052,0,0,0,0,0,0,12310,443,12753
ORISSA,2011,Educational Standard - Illiterate,1219,31,1250,2113,156,2269,0,0,0,0,0,0,3332,187,3519
ORISSA,2011,Educational Standard - Below Class X,1162,45,1207,4436,148,4584,0,0,0,0,0,0,5598,193,5791
ORISSA,2011,Educational Standard - Class X and above but below graduate,997,32,1029,1878,27,1905,0,0,0,0,0,0,2875,59,2934
ORISSA,2011,Educational Standard - Graduate,204,4,208,262,0,262,0,0,0,0,0,0,466,4,470
ORISSA,2011,Educational Standard - Post-Graduate,6,0,6,30,0,30,0,0,0,0,0,0,36,0,36
ORISSA,2011,Educational Standard - Holding technical degree/diploma etc,1,0,1,2,0,2,0,0,0,0,0,0,3,0,3
ORISSA,2012,Educational Standard,3525,105,3630,8866,371,9237,0,0,0,0,0,0,12391,476,12867
ORISSA,2012,Educational Standard - Illiterate,1199,29,1228,2153,176,2329,0,0,0,0,0,0,3352,205,3557
ORISSA,2012,Educational Standard - Below Class X,1142,41,1183,4536,168,4704,0,0,0,0,0,0,5678,209,5887
ORISSA,2012,Educational Standard - Class X and above but below graduate,977,31,1008,1883,27,1910,0,0,0,0,0,0,2860,58,2918
ORISSA,2012,Educational Standard - Graduate,201,4,205,262,0,262,0,0,0,0,0,0,463,4,467
ORISSA,2012,Educational Standard - Post-Graduate,5,0,5,30,0,30,0,0,0,0,0,0,35,0,35
ORISSA,2012,Educational Standard - Holding technical degree/diploma etc,1,0,1,2,0,2,0,0,0,0,0,0,3,0,3
PUNJAB,2001,Educational Standard,3524,170,3694,7755,453,8208,12,0,12,135,5,140,11426,628,12054
PUNJAB,2001,Educational Standard - Illiterate,765,94,859,3530,102,3632,0,0,0,42,2,44,4337,198,4535
PUNJAB,2001,Educational Standard - Below Class X,1604,40,1644,2204,206,2410,2,0,2,56,3,59,3866,249,4115
PUNJAB,2001,Educational Standard - Class X and above but below graduate,1056,22,1078,1510,90,1600,7,0,7,32,0,32,2605,112,2717
PUNJAB,2001,Educational Standard - Graduate,88,8,96,476,36,512,3,0,3,3,0,3,570,44,614
PUNJAB,2001,Educational Standard - Post-Graduate,6,4,10,10,12,22,0,0,0,2,0,2,18,16,34
PUNJAB,2001,Educational Standard - Holding technical degree/diploma etc,5,2,7,25,7,32,0,0,0,0,0,0,30,9,39
PUNJAB,2002,Educational Standard,3725,259,3984,7642,471,8113,12,0,12,0,0,0,11379,730,12109
PUNJAB,2002,Educational Standard - Illiterate,1647,170,1817,3975,210,4185,12,0,12,0,0,0,5634,380,6014
PUNJAB,2002,Educational Standard - Below Class X,1099,66,1165,2566,162,2728,0,0,0,0,0,0,3665,228,3893
PUNJAB,2002,Educational Standard - Class X and above but below graduate,807,20,827,999,47,1046,0,0,0,0,0,0,1806,67,1873
PUNJAB,2002,Educational Standard - Graduate,94,0,94,83,33,116,0,0,0,0,0,0,177,33,210
PUNJAB,2002,Educational Standard - Post-Graduate,78,3,81,19,19,38,0,0,0,0,0,0,97,22,119
PUNJAB,2002,Educational Standard - Holding technical degree/diploma etc,0,0,0,0,0,0,0,0,0,0,0,0,0,0,0
PUNJAB,2003,Educational Standard,4153,264,4417,8244,538,8782,2,0,2,31,0,31,12430,802,13232
PUNJAB,2003,Educational Standard - Illiterate,1596,224,1820,4596,208,4804,2,0,2,31,0,31,6225,432,6657
PUNJAB,2003,Educational Standard - Below Class X,1215,19,1234,1350,193,1543,0,0,0,0,0,0,2565,212,2777
PUNJAB,2003,Educational Standard - Class X and above but below graduate,704,11,715,1374,103,1477,0,0,0,0,0,0,2078,114,2192
PUNJAB,2003,Educational Standard - Graduate,638,10,648,924,34,958,0,0,0,0,0,0,1562,44,1606
PUNJAB,2003,Educational Standard - Post-Graduate,0,0,0,0,0,0,0,0,0,0,0,0,0,0,0
PUNJAB,2003,Educational Standard - Holding technical degree/diploma etc,0,0,0,0,0,0,0,0,0,0,0,0,0,0,0
PUNJAB,2004,Educational Standard,4751,274,5025,9500,501,10001,23,0,23,15,0,15,14289,775,15064
PUNJAB,2004,Educational Standard - Illiterate,1675,227,1902,5503,210,5713,23,0,23,15,0,15,7216,437,7653
PUNJAB,2004,Educational Standard - Below Class X,1383,21,1404,1564,130,1694,0,0,0,0,0,0,2947,151,3098
PUNJAB,2004,Educational Standard - Class X and above but below graduate,897,11,908,1423,99,1522,0,0,0,0,0,0,2320,110,2430
PUNJAB,2004,Educational Standard - Graduate,700,12,712,950,32,982,0,0,0,0,0,0,1650,44,1694
PUNJAB,2004,Educational Standard - Post-Graduate,96,3,99,60,30,90,0,0,0,0,0,0,156,33,189
PUNJAB,2004,Educational Standard - Holding technical degree/diploma etc,0,0,0,0,0,0,0,0,0,0,0,0,0,0,0
PUNJAB,2005,Educational Standard,4835,237,5072,9029,543,9572,23,0,23,11,0,11,13898,780,14678
PUNJAB,2005,Educational Standard - Illiterate,1755,180,1935,5346,196,5542,23,0,23,11,0,11,7135,376,7511
PUNJAB,2005,Educational Standard - Below Class X,1209,28,1237,1416,166,1582,0,0,0,0,0,0,2625,194,2819
PUNJAB,2005,Educational Standard - Class X and above but below graduate,1118,10,1128,1392,108,1500,0,0,0,0,0,0,2510,118,2628
PUNJAB,2005,Educational Standard - Graduate,637,14,651,810,48,858,0,0,0,0,0,0,1447,62,1509
PUNJAB,2005,Educational Standard - Post-Graduate,107,5,112,65,25,90,0,0,0,0,0,0,172,30,202
PUNJAB,2005,Educational Standard - Holding technical degree/diploma etc,9,0,9,0,0,0,0,0,0,0,0,0,9,0,9
PUNJAB,2006,Educational Standard,5083,257,5340,9232,519,9751,20,0,20,4,0,4,14339,776,15115
PUNJAB,2006,Educational Standard - Illiterate,1827,187,2014,5409,188,5597,20,0,20,4,0,4,7260,375,7635
PUNJAB,2006,Educational Standard - Below Class X,1267,34,1301,1473,158,1631,0,0,0,0,0,0,2740,192,2932
PUNJAB,2006,Educational Standard - Class X and above but below graduate,1165,12,1177,1441,104,1545,0,0,0,0,0,0,2606,116,2722
PUNJAB,2006,Educational Standard - Graduate,675,17,692,839,46,885,0,0,0,0,0,0,1514,63,1577
PUNJAB,2006,Educational Standard - Post-Graduate,139,7,146,70,23,93,0,0,0,0,0,0,209,30,239
PUNJAB,2006,Educational Standard - Holding technical degree/diploma etc,10,0,10,0,0,0,0,0,0,0,0,0,10,0,10
PUNJAB,2007,Educational Standard,4745,214,4959,10360,621,10981,16,0,16,16,0,16,15137,835,15972
PUNJAB,2007,Educational Standard - Illiterate,2056,173,2229,6072,242,6314,0,0,0,16,0,16,8144,415,8559
PUNJAB,2007,Educational Standard - Below Class X,1200,21,1221,1686,171,1857,16,0,16,0,0,0,2902,192,3094
PUNJAB,2007,Educational Standard - Class X and above but below graduate,973,7,980,1667,153,1820,0,0,0,0,0,0,2640,160,2800
PUNJAB,2007,Educational Standard - Graduate,453,11,464,740,38,778,0,0,0,0,0,0,1193,49,1242
PUNJAB,2007,Educational Standard - Post-Graduate,42,2,44,195,17,212,0,0,0,0,0,0,237,19,256
PUNJAB,2007,Educational Standard - Holding technical degree/diploma etc,21,0,21,0,0,0,0,0,0,0,0,0,21,0,21
PUNJAB,2008,Educational Standard,5207,264,5471,10071,558,10629,13,0,13,2,0,2,15293,822,16115
PUNJAB,2008,Educational Standard - Illiterate,2252,204,2456,6155,219,6374,0,0,0,2,0,2,8409,423,8832
PUNJAB,2008,Educational Standard - Below Class X,1306,32,1338,1743,159,1902,13,0,13,0,0,0,3062,191,3253
PUNJAB,2008,Educational Standard - Class X and above but below graduate,1002,9,1011,1124,141,1265,0,0,0,0,0,0,2126,150,2276
PUNJAB,2008,Educational Standard - Graduate,561,14,575,797,27,824,0,0,0,0,0,0,1358,41,1399
PUNJAB,2008,Educational Standard - Post-Graduate,61,5,66,252,12,264,0,0,0,0,0,0,313,17,330
PUNJAB,2008,Educational Standard - Holding technical degree/diploma etc,25,0,25,0,0,0,0,0,0,0,0,0,25,0,25
PUNJAB,2009,Educational Standard,6086,352,6438,10762,629,11391,13,0,13,12,0,12,16873,981,17854
PUNJAB,2009,Educational Standard - Illiterate,2593,261,2854,6301,196,6497,1,0,1,0,0,0,8895,457,9352
PUNJAB,2009,Educational Standard - Below Class X,1619,48,1667,2208,259,2467,12,0,12,9,0,9,3848,307,4155
PUNJAB,2009,Educational Standard - Class X and above but below graduate,1203,19,1222,1254,141,1395,0,0,0,3,0,3,2460,160,2620
PUNJAB,2009,Educational Standard - Graduate,579,17,596,744,23,767,0,0,0,0,0,0,1323,40,1363
PUNJAB,2009,Educational Standard - Post-Graduate,65,7,72,255,10,265,0,0,0,0,0,0,320,17,337
PUNJAB,2009,Educational Standard - Holding technical degree/diploma etc,27,0,27,0,0,0,0,0,0,0,0,0,27,0,27
PUNJAB,2010,Educational Standard,6293,356,6649,10333,662,10995,0,0,0,0,0,0,16626,1018,17644
PUNJAB,2010,Educational Standard - Illiterate,2393,192,2585,5272,149,5421,0,0,0,0,0,0,7665,341,8006
PUNJAB,2010,Educational Standard - Below Class X,1959,136,2095,3290,348,3638,0,0,0,0,0,0,5249,484,5733
PUNJAB,2010,Educational Standard - Class X and above but below graduate,1263,16,1279,1224,145,1369,0,0,0,0,0,0,2487,161,2648
PUNJAB,2010,Educational Standard - Graduate,594,8,602,398,12,410,0,0,0,0,0,0,992,20,1012
PUNJAB,2010,Educational Standard - Post-Graduate,59,4,63,134,8,142,0,0,0,0,0,0,193,12,205
PUNJAB,2010,Educational Standard - Holding technical degree/diploma etc,25,0,25,15,0,15,0,0,0,0,0,0,40,0,40
PUNJAB,2011,Educational Standard,7072,454,7526,9712,583,10295,0,0,0,0,0,0,16784,1037,17821
PUNJAB,2011,Educational Standard - Illiterate,2758,223,2981,4771,120,4891,0,0,0,0,0,0,7529,343,7872
PUNJAB,2011,Educational Standard - Below Class X,2114,203,2317,3177,320,3497,0,0,0,0,0,0,5291,523,5814
PUNJAB,2011,Educational Standard - Class X and above but below graduate,1646,18,1664,1231,135,1366,0,0,0,0,0,0,2877,153,3030
PUNJAB,2011,Educational Standard - Graduate,469,6,475,393,8,401,0,0,0,0,0,0,862,14,876
PUNJAB,2011,Educational Standard - Post-Graduate,57,4,61,130,0,130,0,0,0,0,0,0,187,4,191
PUNJAB,2011,Educational Standard - Holding technical degree/diploma etc,28,0,28,10,0,10,0,0,0,0,0,0,38,0,38
PUNJAB,2012,Educational Standard,7424,407,7831,14508,865,15373,7,1,8,5,2,7,21944,1275,23219
PUNJAB,2012,Educational Standard - Illiterate,2377,124,2501,4492,280,4772,0,0,0,3,0,3,6872,404,7276
PUNJAB,2012,Educational Standard - Below Class X,2715,145,2860,4819,325,5144,3,1,4,2,2,4,7539,473,8012
PUNJAB,2012,Educational Standard - Class X and above but below graduate,1699,88,1787,3767,187,3954,3,0,3,0,0,0,5469,275,5744
PUNJAB,2012,Educational Standard - Graduate,422,28,450,939,56,995,1,0,1,0,0,0,1362,84,1446
PUNJAB,2012,Educational Standard - Post-Graduate,129,15,144,346,14,360,0,0,0,0,0,0,475,29,504
PUNJAB,2012,Educational Standard - Holding technical degree/diploma etc,82,7,89,145,3,148,0,0,0,0,0,0,227,10,237
RAJASTHAN,2001,Educational Standard,4080,103,4183,8469,268,8737,47,0,47,28,0,28,12624,371,12995
RAJASTHAN,2001,Educational Standard - Illiterate,1222,49,1271,2891,165,3056,6,0,6,15,0,15,4134,214,4348
RAJASTHAN,2001,Educational Standard - Below Class X,1927,45,1972,3934,90,4024,32,0,32,9,0,9,5902,135,6037
RAJASTHAN,2001,Educational Standard - Class X and above but below graduate,623,8,631,1193,10,1203,6,0,6,4,0,4,1826,18,1844
RAJASTHAN,2001,Educational Standard - Graduate,223,1,224,336,2,338,3,0,3,0,0,0,562,3,565
RAJASTHAN,2001,Educational Standard - Post-Graduate,70,0,70,92,1,93,0,0,0,0,0,0,162,1,163
RAJASTHAN,2001,Educational Standard - Holding technical degree/diploma etc,15,0,15,23,0,23,0,0,0,0,0,0,38,0,38
RAJASTHAN,2002,Educational Standard,4790,186,4976,7115,207,7322,38,0,38,50,0,50,11993,393,12386
RAJASTHAN,2002,Educational Standard - Illiterate,1107,39,1146,2109,115,2224,0,0,0,21,0,21,3237,154,3391
RAJASTHAN,2002,Educational Standard - Below Class X,2675,66,2741,3632,67,3699,31,0,31,22,0,22,6360,133,6493
RAJASTHAN,2002,Educational Standard - Class X and above but below graduate,677,57,734,1032,19,1051,3,0,3,7,0,7,1719,76,1795
RAJASTHAN,2002,Educational Standard - Graduate,181,19,200,250,4,254,3,0,3,0,0,0,434,23,457
RAJASTHAN,2002,Educational Standard - Post-Graduate,70,5,75,87,2,89,1,0,1,0,0,0,158,7,165
RAJASTHAN,2002,Educational Standard - Holding technical degree/diploma etc,80,0,80,5,0,5,0,0,0,0,0,0,85,0,85
RAJASTHAN,2003,Educational Standard,5861,192,6053,6366,218,6584,32,0,32,26,0,26,12285,410,12695
RAJASTHAN,2003,Educational Standard - Illiterate,1809,28,1837,1921,136,2057,3,0,3,14,0,14,3747,164,3911
RAJASTHAN,2003,Educational Standard - Below Class X,2986,87,3073,3136,58,3194,24,0,24,11,0,11,6157,145,6302
RAJASTHAN,2003,Educational Standard - Class X and above but below graduate,704,48,752,952,15,967,3,0,3,1,0,1,1660,63,1723
RAJASTHAN,2003,Educational Standard - Graduate,205,23,228,241,6,247,2,0,2,0,0,0,448,29,477
RAJASTHAN,2003,Educational Standard - Post-Graduate,69,6,75,86,3,89,0,0,0,0,0,0,155,9,164
RAJASTHAN,2003,Educational Standard - Holding technical degree/diploma etc,88,0,88,30,0,30,0,0,0,0,0,0,118,0,118
RAJASTHAN,2004,Educational Standard,5659,179,5838,7028,255,7283,29,0,29,21,0,21,12737,434,13171
RAJASTHAN,2004,Educational Standard - Illiterate,1358,71,1429,2137,133,2270,5,0,5,8,0,8,3508,204,3712
RAJASTHAN,2004,Educational Standard - Below Class X,3253,98,3351,3442,107,3549,16,0,16,13,0,13,6724,205,6929
RAJASTHAN,2004,Educational Standard - Class X and above but below graduate,791,8,799,1173,14,1187,6,0,6,0,0,0,1970,22,1992
RAJASTHAN,2004,Educational Standard - Graduate,147,1,148,180,1,181,2,0,2,0,0,0,329,2,331
RAJASTHAN,2004,Educational Standard - Post-Graduate,64,0,64,68,0,68,0,0,0,0,0,0,132,0,132
RAJASTHAN,2004,Educational Standard - Holding technical degree/diploma etc,46,1,47,28,0,28,0,0,0,0,0,0,74,1,75
RAJASTHAN,2005,Educational Standard,5391,181,5572,7116,247,7363,32,0,32,26,0,26,12565,428,12993
RAJASTHAN,2005,Educational Standard - Illiterate,1399,45,1444,2098,133,2231,4,0,4,12,0,12,3513,178,3691
RAJASTHAN,2005,Educational Standard - Below Class X,2454,107,2561,3395,84,3479,16,0,16,9,0,9,5874,191,6065
RAJASTHAN,2005,Educational Standard - Class X and above but below graduate,984,24,1008,1049,24,1073,10,0,10,3,0,3,2046,48,2094
RAJASTHAN,2005,Educational Standard - Graduate,259,3,262,285,6,291,2,0,2,2,0,2,548,9,557
RAJASTHAN,2005,Educational Standard - Post-Graduate,129,1,130,134,0,134,0,0,0,0,0,0,263,1,264
RAJASTHAN,2005,Educational Standard - Holding technical degree/diploma etc,166,1,167,155,0,155,0,0,0,0,0,0,321,1,322
RAJASTHAN,2006,Educational Standard,5406,187,5593,8004,284,8288,35,0,35,67,0,67,13512,471,13983
RAJASTHAN,2006,Educational Standard - Illiterate,1460,95,1555,2279,157,2436,10,0,10,20,0,20,3769,252,4021
RAJASTHAN,2006,Educational Standard - Below Class X,2626,81,2707,3911,112,4023,10,0,10,32,0,32,6579,193,6772
RAJASTHAN,2006,Educational Standard - Class X and above but below graduate,823,11,834,1219,13,1232,7,0,7,15,0,15,2064,24,2088
RAJASTHAN,2006,Educational Standard - Graduate,246,0,246,288,2,290,5,0,5,0,0,0,539,2,541
RAJASTHAN,2006,Educational Standard - Post-Graduate,136,0,136,176,0,176,0,0,0,0,0,0,312,0,312
RAJASTHAN,2006,Educational Standard - Holding technical degree/diploma etc,115,0,115,131,0,131,3,0,3,0,0,0,249,0,249
RAJASTHAN,2007,Educational Standard,5678,192,5870,8423,342,8765,26,0,26,26,0,26,14153,534,14687
RAJASTHAN,2007,Educational Standard - Illiterate,1691,42,1733,2497,189,2686,0,0,0,11,0,11,4199,231,4430
RAJASTHAN,2007,Educational Standard - Below Class X,2557,31,2588,3830,106,3936,12,0,12,15,0,15,6414,137,6551
RAJASTHAN,2007,Educational Standard - Class X and above but below graduate,931,116,1047,1414,42,1456,8,0,8,0,0,0,2353,158,2511
RAJASTHAN,2007,Educational Standard - Graduate,263,3,266,408,5,413,4,0,4,0,0,0,675,8,683
RAJASTHAN,2007,Educational Standard - Post-Graduate,121,0,121,159,0,159,0,0,0,0,0,0,280,0,280
RAJASTHAN,2007,Educational Standard - Holding technical degree/diploma etc,115,0,115,115,0,115,2,0,2,0,0,0,232,0,232
RAJASTHAN,2008,Educational Standard,6063,217,6280,8790,330,9120,55,0,55,65,0,65,14973,547,15520
RAJASTHAN,2008,Educational Standard - Illiterate,1806,124,1930,2732,197,2929,9,0,9,14,0,14,4561,321,4882
RAJASTHAN,2008,Educational Standard - Below Class X,2517,71,2588,3615,101,3716,27,0,27,34,0,34,6193,172,6365
RAJASTHAN,2008,Educational Standard - Class X and above but below graduate,1091,18,1109,1674,22,1696,13,0,13,4,0,4,2782,40,2822
RAJASTHAN,2008,Educational Standard - Graduate,357,2,359,443,7,450,6,0,6,11,0,11,817,9,826
RAJASTHAN,2008,Educational Standard - Post-Graduate,154,1,155,220,2,222,0,0,0,2,0,2,376,3,379
RAJASTHAN,2008,Educational Standard - Holding technical degree/diploma etc,138,1,139,106,1,107,0,0,0,0,0,0,244,2,246
RAJASTHAN,2009,Educational Standard,6307,245,6552,10902,411,11313,27,0,27,40,0,40,17276,656,17932
RAJASTHAN,2009,Educational Standard - Illiterate,1734,104,1838,3131,233,3364,3,0,3,22,0,22,4890,337,5227
RAJASTHAN,2009,Educational Standard - Below Class X,2070,115,2185,4241,119,4360,9,0,9,13,0,13,6333,234,6567
RAJASTHAN,2009,Educational Standard - Class X and above but below graduate,1836,16,1852,2467,51,2518,15,0,15,1,0,1,4319,67,4386
RAJASTHAN,2009,Educational Standard - Graduate,371,5,376,649,7,656,0,0,0,4,0,4,1024,12,1036
RAJASTHAN,2009,Educational Standard - Post-Graduate,131,4,135,247,1,248,0,0,0,0,0,0,378,5,383
RAJASTHAN,2009,Educational Standard - Holding technical degree/diploma etc,165,1,166,167,0,167,0,0,0,0,0,0,332,1,333
RAJASTHAN,2010,Educational Standard,6010,222,6232,10543,385,10928,30,0,30,4,0,4,16587,607,17194
RAJASTHAN,2010,Educational Standard - Illiterate,1641,153,1794,3262,221,3483,8,0,8,1,0,1,4912,374,5286
RAJASTHAN,2010,Educational Standard - Below Class X,1992,27,2019,4090,107,4197,8,0,8,0,0,0,6090,134,6224
RAJASTHAN,2010,Educational Standard - Class X and above but below graduate,1705,29,1734,2363,51,2414,13,0,13,3,0,3,4084,80,4164
RAJASTHAN,2010,Educational Standard - Graduate,373,6,379,481,5,486,0,0,0,0,0,0,854,11,865
RAJASTHAN,2010,Educational Standard - Post-Graduate,170,3,173,227,1,228,1,0,1,0,0,0,398,4,402
RAJASTHAN,2010,Educational Standard - Holding technical degree/diploma etc,129,4,133,120,0,120,0,0,0,0,0,0,249,4,253
RAJASTHAN,2011,Educational Standard,5928,231,6159,11480,419,11899,40,0,40,6,0,6,17454,650,18104
RAJASTHAN,2011,Educational Standard - Illiterate,1393,110,1503,3215,176,3391,12,0,12,0,0,0,4620,286,4906
RAJASTHAN,2011,Educational Standard - Below Class X,2162,92,2254,4506,160,4666,10,0,10,0,0,0,6678,252,6930
RAJASTHAN,2011,Educational Standard - Class X and above but below graduate,1610,17,1627,2601,70,2671,18,0,18,0,0,0,4229,87,4316
RAJASTHAN,2011,Educational Standard - Graduate,398,6,404,676,13,689,0,0,0,1,0,1,1075,19,1094
RAJASTHAN,2011,Educational Standard - Post-Graduate,242,5,247,319,0,319,0,0,0,2,0,2,563,5,568
RAJASTHAN,2011,Educational Standard - Holding technical degree/diploma etc,123,1,124,163,0,163,0,0,0,3,0,3,289,1,290
RAJASTHAN,2012,Educational Standard,5843,240,6083,12715,455,13170,1,0,1,97,0,97,18656,695,19351
RAJASTHAN,2012,Educational Standard - Illiterate,1642,175,1817,3278,240,3518,0,0,0,50,0,50,4970,415,5385
RAJASTHAN,2012,Educational Standard - Below Class X,2433,51,2484,4763,128,4891,0,0,0,45,0,45,7241,179,7420
RAJASTHAN,2012,Educational Standard - Class X and above but below graduate,1271,6,1277,3129,62,3191,0,0,0,2,0,2,4402,68,4470
RAJASTHAN,2012,Educational Standard - Graduate,271,3,274,895,15,910,1,0,1,0,0,0,1167,18,1185
RAJASTHAN,2012,Educational Standard - Post-Graduate,133,3,136,395,4,399,0,0,0,0,0,0,528,7,535
RAJASTHAN,2012,Educational Standard - Holding technical degree/diploma etc,93,2,95,255,6,261,0,0,0,0,0,0,348,8,356
SIKKIM,2001,Educational Standard,77,0,77,109,0,109,0,0,0,0,0,0,186,0,186
SIKKIM,2001,Educational Standard - Illiterate,20,0,20,26,0,26,0,0,0,0,0,0,46,0,46
SIKKIM,2001,Educational Standard - Below Class X,43,0,43,52,0,52,0,0,0,0,0,0,95,0,95
SIKKIM,2001,Educational Standard - Class X and above but below graduate,10,0,10,26,0,26,0,0,0,0,0,0,36,0,36
SIKKIM,2001,Educational Standard - Graduate,4,0,4,5,0,5,0,0,0,0,0,0,9,0,9
SIKKIM,2001,Educational Standard - Post-Graduate,0,0,0,0,0,0,0,0,0,0,0,0,0,0,0
SIKKIM,2001,Educational Standard - Holding technical degree/diploma etc,0,0,0,0,0,0,0,0,0,0,0,0,0,0,0
SIKKIM,2002,Educational Standard,81,0,81,89,2,91,0,0,0,0,0,0,170,2,172
SIKKIM,2002,Educational Standard - Illiterate,20,0,20,18,1,19,0,0,0,0,0,0,38,1,39
SIKKIM,2002,Educational Standard - Below Class X,45,0,45,52,0,52,0,0,0,0,0,0,97,0,97
SIKKIM,2002,Educational Standard - Class X and above but below graduate,10,0,10,15,0,15,0,0,0,0,0,0,25,0,25
SIKKIM,2002,Educational Standard - Graduate,6,0,6,4,1,5,0,0,0,0,0,0,10,1,11
SIKKIM,2002,Educational Standard - Post-Graduate,0,0,0,0,0,0,0,0,0,0,0,0,0,0,0
SIKKIM,2002,Educational Standard - Holding technical degree/diploma etc,0,0,0,0,0,0,0,0,0,0,0,0,0,0,0
SIKKIM,2003,Educational Standard,80,2,82,87,2,89,0,0,0,0,0,0,167,4,171
SIKKIM,2003,Educational Standard - Illiterate,35,1,36,32,0,32,0,0,0,0,0,0,67,1,68
SIKKIM,2003,Educational Standard - Below Class X,34,0,34,35,2,37,0,0,0,0,0,0,69,2,71
SIKKIM,2003,Educational Standard - Class X and above but below graduate,7,0,7,18,0,18,0,0,0,0,0,0,25,0,25
SIKKIM,2003,Educational Standard - Graduate,4,1,5,2,0,2,0,0,0,0,0,0,6,1,7
SIKKIM,2003,Educational Standard - Post-Graduate,0,0,0,0,0,0,0,0,0,0,0,0,0,0,0
SIKKIM,2003,Educational Standard - Holding technical degree/diploma etc,0,0,0,0,0,0,0,0,0,0,0,0,0,0,0
SIKKIM,2004,Educational Standard,61,2,63,99,0,99,0,0,0,0,0,0,160,2,162
SIKKIM,2004,Educational Standard - Illiterate,12,0,12,25,0,25,0,0,0,0,0,0,37,0,37
SIKKIM,2004,Educational Standard - Below Class X,42,1,43,65,0,65,0,0,0,0,0,0,107,1,108
SIKKIM,2004,Educational Standard - Class X and above but below graduate,5,0,5,3,0,3,0,0,0,0,0,0,8,0,8
SIKKIM,2004,Educational Standard - Graduate,2,1,3,5,0,5,0,0,0,0,0,0,7,1,8
SIKKIM,2004,Educational Standard - Post-Graduate,0,0,0,0,0,0,0,0,0,0,0,0,0,0,0
SIKKIM,2004,Educational Standard - Holding technical degree/diploma etc,0,0,0,1,0,1,0,0,0,0,0,0,1,0,1
SIKKIM,2005,Educational Standard,71,2,73,117,5,122,0,0,0,0,0,0,188,7,195
SIKKIM,2005,Educational Standard - Illiterate,13,0,13,30,0,30,0,0,0,0,0,0,43,0,43
SIKKIM,2005,Educational Standard - Below Class X,49,1,50,78,5,83,0,0,0,0,0,0,127,6,133
SIKKIM,2005,Educational Standard - Class X and above but below graduate,7,0,7,3,0,3,0,0,0,0,0,0,10,0,10
SIKKIM,2005,Educational Standard - Graduate,2,1,3,5,0,5,0,0,0,0,0,0,7,1,8
SIKKIM,2005,Educational Standard - Post-Graduate,0,0,0,0,0,0,0,0,0,0,0,0,0,0,0
SIKKIM,2005,Educational Standard - Holding technical degree/diploma etc,0,0,0,1,0,1,0,0,0,0,0,0,1,0,1
SIKKIM,2006,Educational Standard,90,1,91,132,2,134,0,0,0,0,0,0,222,3,225
SIKKIM,2006,Educational Standard - Illiterate,21,0,21,34,0,34,0,0,0,0,0,0,55,0,55
SIKKIM,2006,Educational Standard - Below Class X,60,1,61,78,2,80,0,0,0,0,0,0,138,3,141
SIKKIM,2006,Educational Standard - Class X and above but below graduate,6,0,6,16,0,16,0,0,0,0,0,0,22,0,22
SIKKIM,2006,Educational Standard - Graduate,3,0,3,4,0,4,0,0,0,0,0,0,7,0,7
SIKKIM,2006,Educational Standard - Post-Graduate,0,0,0,0,0,0,0,0,0,0,0,0,0,0,0
SIKKIM,2006,Educational Standard - Holding technical degree/diploma etc,0,0,0,0,0,0,0,0,0,0,0,0,0,0,0
SIKKIM,2007,Educational Standard,81,1,82,141,3,144,0,0,0,0,0,0,222,4,226
SIKKIM,2007,Educational Standard - Illiterate,20,0,20,30,0,30,0,0,0,0,0,0,50,0,50
SIKKIM,2007,Educational Standard - Below Class X,51,1,52,92,3,95,0,0,0,0,0,0,143,4,147
SIKKIM,2007,Educational Standard - Class X and above but below graduate,7,0,7,17,0,17,0,0,0,0,0,0,24,0,24
SIKKIM,2007,Educational Standard - Graduate,3,0,3,2,0,2,0,0,0,0,0,0,5,0,5
SIKKIM,2007,Educational Standard - Post-Graduate,0,0,0,0,0,0,0,0,0,0,0,0,0,0,0
SIKKIM,2007,Educational Standard - Holding technical degree/diploma etc,0,0,0,0,0,0,0,0,0,0,0,0,0,0,0
SIKKIM,2008,Educational Standard,67,1,68,184,8,192,0,0,0,0,0,0,251,9,260
SIKKIM,2008,Educational Standard - Illiterate,14,0,14,37,3,40,0,0,0,0,0,0,51,3,54
SIKKIM,2008,Educational Standard - Below Class X,41,1,42,130,1,131,0,0,0,0,0,0,171,2,173
SIKKIM,2008,Educational Standard - Class X and above but below graduate,10,0,10,13,4,17,0,0,0,0,0,0,23,4,27
SIKKIM,2008,Educational Standard - Graduate,2,0,2,4,0,4,0,0,0,0,0,0,6,0,6
SIKKIM,2008,Educational Standard - Post-Graduate,0,0,0,0,0,0,0,0,0,0,0,0,0,0,0
SIKKIM,2008,Educational Standard - Holding technical degree/diploma etc,0,0,0,0,0,0,0,0,0,0,0,0,0,0,0
SIKKIM,2009,Educational Standard,68,1,69,118,6,124,0,0,0,0,0,0,186,7,193
SIKKIM,2009,Educational Standard - Illiterate,14,0,14,21,0,21,0,0,0,0,0,0,35,0,35
SIKKIM,2009,Educational Standard - Below Class X,51,1,52,92,5,97,0,0,0,0,0,0,143,6,149
SIKKIM,2009,Educational Standard - Class X and above but below graduate,2,0,2,5,1,6,0,0,0,0,0,0,7,1,8
SIKKIM,2009,Educational Standard - Graduate,1,0,1,0,0,0,0,0,0,0,0,0,1,0,1
SIKKIM,2009,Educational Standard - Post-Graduate,0,0,0,0,0,0,0,0,0,0,0,0,0,0,0
SIKKIM,2009,Educational Standard - Holding technical degree/diploma etc,0,0,0,0,0,0,0,0,0,0,0,0,0,0,0
SIKKIM,2010,Educational Standard,74,2,76,126,5,131,0,0,0,0,0,0,200,7,207
SIKKIM,2010,Educational Standard - Illiterate,7,1,8,15,1,16,0,0,0,0,0,0,22,2,24
SIKKIM,2010,Educational Standard - Below Class X,53,1,54,90,3,93,0,0,0,0,0,0,143,4,147
SIKKIM,2010,Educational Standard - Class X and above but below graduate,11,0,11,20,1,21,0,0,0,0,0,0,31,1,32
SIKKIM,2010,Educational Standard - Graduate,3,0,3,1,0,1,0,0,0,0,0,0,4,0,4
SIKKIM,2010,Educational Standard - Post-Graduate,0,0,0,0,0,0,0,0,0,0,0,0,0,0,0
SIKKIM,2010,Educational Standard - Holding technical degree/diploma etc,0,0,0,0,0,0,0,0,0,0,0,0,0,0,0
SIKKIM,2011,Educational Standard,69,1,70,119,1,120,0,0,0,0,0,0,188,2,190
SIKKIM,2011,Educational Standard - Illiterate,23,1,24,26,0,26,0,0,0,0,0,0,49,1,50
SIKKIM,2011,Educational Standard - Below Class X,38,0,38,66,1,67,0,0,0,0,0,0,104,1,105
SIKKIM,2011,Educational Standard - Class X and above but below graduate,6,0,6,26,0,26,0,0,0,0,0,0,32,0,32
SIKKIM,2011,Educational Standard - Graduate,2,0,2,1,0,1,0,0,0,0,0,0,3,0,3
SIKKIM,2011,Educational Standard - Post-Graduate,0,0,0,0,0,0,0,0,0,0,0,0,0,0,0
SIKKIM,2011,Educational Standard - Holding technical degree/diploma etc,0,0,0,0,0,0,0,0,0,0,0,0,0,0,0
SIKKIM,2012,Educational Standard,87,1,88,143,5,148,0,0,0,0,0,0,230,6,236
SIKKIM,2012,Educational Standard - Illiterate,14,0,14,32,2,34,0,0,0,0,0,0,46,2,48
SIKKIM,2012,Educational Standard - Below Class X,65,1,66,99,3,102,0,0,0,0,0,0,164,4,168
SIKKIM,2012,Educational Standard - Class X and above but below graduate,6,0,6,8,0,8,0,0,0,0,0,0,14,0,14
SIKKIM,2012,Educational Standard - Graduate,2,0,2,3,0,3,0,0,0,0,0,0,5,0,5
SIKKIM,2012,Educational Standard - Post-Graduate,0,0,0,1,0,1,0,0,0,0,0,0,1,0,1
SIKKIM,2012,Educational Standard - Holding technical degree/diploma etc,0,0,0,0,0,0,0,0,0,0,0,0,0,0,0
TAMILNADU,2001,Educational Standard,4698,159,4857,2224,141,2365,1014,219,1233,11364,1441,12805,19300,1960,21260
TAMILNADU,2001,Educational Standard - Illiterate,2129,77,2206,1093,101,1194,477,127,604,5542,1021,6563,9241,1326,10567
TAMILNADU,2001,Educational Standard - Below Class X,1889,53,1942,1002,28,1030,286,34,320,4197,344,4541,7374,459,7833
TAMILNADU,2001,Educational Standard - Class X and above but below graduate,479,16,495,79,11,90,218,58,276,1520,71,1591,2296,156,2452
TAMILNADU,2001,Educational Standard - Graduate,171,0,171,18,1,19,32,0,32,78,5,83,299,6,305
TAMILNADU,2001,Educational Standard - Post-Graduate,10,11,21,7,0,7,0,0,0,15,0,15,32,11,43
TAMILNADU,2001,Educational Standard - Holding technical degree/diploma etc,20,2,22,25,0,25,1,0,1,12,0,12,58,2,60
TAMILNADU,2002,Educational Standard,5402,180,5582,2508,59,2567,1716,184,1900,10480,1366,11846,20106,1789,21895
TAMILNADU,2002,Educational Standard - Illiterate,1782,126,1908,1126,48,1174,1009,170,1179,4877,974,5851,8794,1318,10112
TAMILNADU,2002,Educational Standard - Below Class X,2263,47,2310,947,11,958,608,13,621,3770,284,4054,7588,355,7943
TAMILNADU,2002,Educational Standard - Graduate,222,1,223,30,0,30,5,0,5,52,0,52,309,1,310
TAMILNADU,2002,Educational Standard - Post-Graduate,56,6,62,12,0,12,4,0,4,17,0,17,89,6,95
TAMILNADU,2003,Educational Standard,5969,192,6161,3015,54,3069,1003,81,1084,10810,1529,12339,20797,1856,22653
TAMILNADU,2003,Educational Standard - Illiterate,1811,137,1948,1461,48,1509,432,61,493,2918,47,2965,6622,293,6915
TAMILNADU,2003,Educational Standard - Below Class X,2663,47,2710,998,6,1004,418,19,437,4739,978,5717,8818,1050,9868
TAMILNADU,2003,Educational Standard - Class X and above but below graduate,1176,0,1176,485,0,485,110,1,111,3022,418,3440,4793,419,5212
TAMILNADU,2003,Educational Standard - Graduate,233,2,235,41,0,41,30,0,30,69,47,116,373,49,422
TAMILNADU,2003,Educational Standard - Post-Graduate,58,6,64,22,0,22,10,0,10,47,31,78,137,37,174
TAMILNADU,2003,Educational Standard - Holding technical degree/diploma etc,28,0,28,8,0,8,3,0,3,15,8,23,54,8,62
TAMILNADU,2004,Educational Standard,6602,201,6803,2859,59,2918,593,19,612,9218,1551,10769,19272,1830,21102
TAMILNADU,2004,Educational Standard - Illiterate,1917,137,2054,1267,43,1310,317,10,327,2827,549,3376,6328,739,7067
TAMILNADU,2004,Educational Standard - Below Class X,2918,52,2970,1018,16,1034,180,4,184,3717,787,4504,7833,859,8692
TAMILNADU,2004,Educational Standard - Class X and above but below graduate,1319,0,1319,496,0,496,77,5,82,2610,171,2781,4502,176,4678
TAMILNADU,2004,Educational Standard - Graduate,317,3,320,45,0,45,6,0,6,38,24,62,406,27,433
TAMILNADU,2004,Educational Standard - Post-Graduate,79,9,88,25,0,25,0,0,0,0,0,0,104,9,113
TAMILNADU,2004,Educational Standard - Holding technical degree/diploma etc,52,0,52,8,0,8,13,0,13,26,20,46,99,20,119
TAMILNADU,2005,Educational Standard,7217,246,7463,2948,60,3008,787,40,827,8120,1263,9383,19072,1609,20681
TAMILNADU,2005,Educational Standard - Illiterate,2176,86,2262,1281,40,1321,433,26,459,3703,556,4259,7593,708,8301
TAMILNADU,2005,Educational Standard - Below Class X,4192,112,4304,1272,16,1288,316,14,330,3756,551,4307,9536,693,10229
TAMILNADU,2005,Educational Standard - Class X and above but below graduate,465,41,506,263,4,267,35,0,35,460,135,595,1223,180,1403
TAMILNADU,2005,Educational Standard - Graduate,229,7,236,53,0,53,3,0,3,172,21,193,457,28,485
TAMILNADU,2005,Educational Standard - Post-Graduate,119,0,119,71,0,71,0,0,0,10,0,10,200,0,200
TAMILNADU,2005,Educational Standard - Holding technical degree/diploma etc,36,0,36,8,0,8,0,0,0,19,0,19,63,0,63
TAMILNADU,2006,Educational Standard,6509,197,6706,2835,50,2885,622,29,651,7236,1178,8414,17202,1454,18656
TAMILNADU,2006,Educational Standard - Illiterate,1718,34,1752,1253,30,1283,273,11,284,2816,470,3286,6060,545,6605
TAMILNADU,2006,Educational Standard - Below Class X,4017,117,4134,1273,17,1290,312,18,330,3761,567,4328,9363,719,10082
TAMILNADU,2006,Educational Standard - Class X and above but below graduate,416,42,458,216,3,219,37,0,37,471,116,587,1140,161,1301
TAMILNADU,2006,Educational Standard - Graduate,214,4,218,38,0,38,0,0,0,167,25,192,419,29,448
TAMILNADU,2006,Educational Standard - Post-Graduate,112,0,112,47,0,47,0,0,0,12,0,12,171,0,171
TAMILNADU,2006,Educational Standard - Holding technical degree/diploma etc,32,0,32,8,0,8,0,0,0,9,0,9,49,0,49
TAMILNADU,2007,Educational Standard,6190,192,6382,8548,994,9542,638,29,667,8,0,8,15384,1215,16599
TAMILNADU,2007,Educational Standard - Illiterate,2069,131,2200,2397,457,2854,213,17,230,8,0,8,4687,605,5292
TAMILNADU,2007,Educational Standard - Below Class X,2730,42,2772,4677,468,5145,357,9,366,0,0,0,7764,519,8283
TAMILNADU,2007,Educational Standard - Class X and above but below graduate,1053,11,1064,1190,67,1257,58,3,61,0,0,0,2301,81,2382
TAMILNADU,2007,Educational Standard - Graduate,200,7,207,150,2,152,10,0,10,0,0,0,360,9,369
TAMILNADU,2007,Educational Standard - Post-Graduate,55,1,56,56,0,56,0,0,0,0,0,0,111,1,112
TAMILNADU,2007,Educational Standard - Holding technical degree/diploma etc,83,0,83,78,0,78,0,0,0,0,0,0,161,0,161
TAMILNADU,2008,Educational Standard,5245,174,5419,8881,865,9746,1003,32,1035,4,0,4,15133,1071,16204
TAMILNADU,2008,Educational Standard - Illiterate,1230,86,1316,2774,408,3182,327,19,346,0,0,0,4331,513,4844
TAMILNADU,2008,Educational Standard - Below Class X,2859,57,2916,4303,332,4635,371,10,381,4,0,4,7537,399,7936
TAMILNADU,2008,Educational Standard - Class X and above but below graduate,808,19,827,1397,111,1508,254,3,257,0,0,0,2459,133,2592
TAMILNADU,2008,Educational Standard - Graduate,159,9,168,194,9,203,24,0,24,0,0,0,377,18,395
TAMILNADU,2008,Educational Standard - Post-Graduate,60,3,63,81,5,86,0,0,0,0,0,0,141,8,149
TAMILNADU,2008,Educational Standard - Holding technical degree/diploma etc,129,0,129,132,0,132,27,0,27,0,0,0,288,0,288
TAMILNADU,2009,Educational Standard,5183,178,5361,7584,575,8159,819,16,835,4,1,5,13590,770,14360
TAMILNADU,2009,Educational Standard - Illiterate,1299,95,1394,2437,369,2806,205,7,212,0,1,1,3941,472,4413
TAMILNADU,2009,Educational Standard - Below Class X,2697,71,2768,3122,147,3269,377,9,386,4,0,4,6200,227,6427
TAMILNADU,2009,Educational Standard - Class X and above but below graduate,746,4,750,1371,40,1411,172,0,172,0,0,0,2289,44,2333
TAMILNADU,2009,Educational Standard - Graduate,203,6,209,404,9,413,34,0,34,0,0,0,641,15,656
TAMILNADU,2009,Educational Standard - Post-Graduate,91,2,93,92,10,102,9,0,9,0,0,0,192,12,204
TAMILNADU,2009,Educational Standard - Holding technical degree/diploma etc,147,0,147,158,0,158,22,0,22,0,0,0,327,0,327
TAMILNADU,2010,Educational Standard,5165,168,5333,7154,543,7697,810,23,833,3,0,3,13132,734,13866
TAMILNADU,2010,Educational Standard - Illiterate,1582,37,1619,3193,250,3443,228,10,238,3,0,3,5006,297,5303
TAMILNADU,2010,Educational Standard - Below Class X,2263,81,2344,2073,243,2316,373,5,378,0,0,0,4709,329,5038
TAMILNADU,2010,Educational Standard - Class X and above but below graduate,792,43,835,1320,46,1366,154,2,156,0,0,0,2266,91,2357
TAMILNADU,2010,Educational Standard - Graduate,240,5,245,319,3,322,29,4,33,0,0,0,588,12,600
TAMILNADU,2010,Educational Standard - Post-Graduate,93,2,95,84,1,85,13,2,15,0,0,0,190,5,195
TAMILNADU,2010,Educational Standard - Holding technical degree/diploma etc,195,0,195,165,0,165,13,0,13,0,0,0,373,0,373
TAMILNADU,2011,Educational Standard,5025,175,5200,7108,574,7682,962,21,983,4,0,4,13099,770,13869
TAMILNADU,2011,Educational Standard - Illiterate,1275,87,1362,2542,369,2911,388,11,399,0,0,0,4205,467,4672
TAMILNADU,2011,Educational Standard - Below Class X,2242,55,2297,1774,121,1895,274,5,279,4,0,4,4294,181,4475
TAMILNADU,2011,Educational Standard - Class X and above but below graduate,920,14,934,1642,46,1688,185,5,190,0,0,0,2747,65,2812
TAMILNADU,2011,Educational Standard - Graduate,292,7,299,433,19,452,75,0,75,0,0,0,800,26,826
TAMILNADU,2011,Educational Standard - Post-Graduate,81,4,85,331,8,339,25,0,25,0,0,0,437,12,449
TAMILNADU,2011,Educational Standard - Holding technical degree/diploma etc,215,8,223,386,11,397,15,0,15,0,0,0,616,19,635
TAMILNADU,2012,Educational Standard,4510,168,4678,7436,558,7994,502,21,523,0,0,0,12448,747,13195
TAMILNADU,2012,Educational Standard - Illiterate,1094,78,1172,3097,418,3515,230,15,245,0,0,0,4421,511,4932
TAMILNADU,2012,Educational Standard - Below Class X,2115,55,2170,2773,101,2874,187,6,193,0,0,0,5075,162,5237
TAMILNADU,2012,Educational Standard - Class X and above but below graduate,787,13,800,938,23,961,44,0,44,0,0,0,1769,36,1805
TAMILNADU,2012,Educational Standard - Graduate,249,6,255,404,12,416,33,0,33,0,0,0,686,18,704
TAMILNADU,2012,Educational Standard - Post-Graduate,59,2,61,75,0,75,6,0,6,0,0,0,140,2,142
TAMILNADU,2012,Educational Standard - Holding technical degree/diploma etc,206,14,220,149,4,153,2,0,2,0,0,0,357,18,375
TRIPURA,2001,Educational Standard,358,4,362,664,12,676,2,0,2,0,0,0,1024,16,1040
TRIPURA,2001,Educational Standard - Illiterate,25,2,27,119,6,125,0,0,0,0,0,0,144,8,152
TRIPURA,2001,Educational Standard - Below Class X,306,2,308,324,5,329,1,0,1,0,0,0,631,7,638
TRIPURA,2001,Educational Standard - Class X and above but below graduate,18,0,18,199,1,200,1,0,1,0,0,0,218,1,219
TRIPURA,2001,Educational Standard - Graduate,6,0,6,18,0,18,0,0,0,0,0,0,24,0,24
TRIPURA,2001,Educational Standard - Post-Graduate,1,0,1,0,0,0,0,0,0,0,0,0,1,0,1
TRIPURA,2001,Educational Standard - Holding technical degree/diploma etc,2,0,2,4,0,4,0,0,0,0,0,0,6,0,6
TRIPURA,2002,Educational Standard,482,6,488,543,8,551,2,0,2,0,0,0,1027,14,1041
TRIPURA,2002,Educational Standard - Illiterate,65,2,67,115,4,119,0,0,0,0,0,0,180,6,186
TRIPURA,2002,Educational Standard - Below Class X,364,2,366,264,3,267,1,0,1,0,0,0,629,5,634
TRIPURA,2002,Educational Standard - Class X and above but below graduate,28,2,30,149,1,150,1,0,1,0,0,0,178,3,181
TRIPURA,2002,Educational Standard - Graduate,11,0,11,12,0,12,0,0,0,0,0,0,23,0,23
TRIPURA,2002,Educational Standard - Post-Graduate,6,0,6,0,0,0,0,0,0,0,0,0,6,0,6
TRIPURA,2002,Educational Standard - Holding technical degree/diploma etc,8,0,8,3,0,3,0,0,0,0,0,0,11,0,11
TRIPURA,2003,Educational Standard,493,7,500,887,11,898,2,0,2,1,0,1,1383,18,1401
TRIPURA,2003,Educational Standard - Illiterate,49,2,51,199,6,205,0,0,0,0,0,0,248,8,256
TRIPURA,2003,Educational Standard - Below Class X,404,3,407,589,5,594,2,0,2,1,0,1,996,8,1004
TRIPURA,2003,Educational Standard - Class X and above but below graduate,30,1,31,96,0,96,0,0,0,0,0,0,126,1,127
TRIPURA,2003,Educational Standard - Graduate,9,1,10,1,0,1,0,0,0,0,0,0,10,1,11
TRIPURA,2003,Educational Standard - Post-Graduate,1,0,1,2,0,2,0,0,0,0,0,0,3,0,3
TRIPURA,2003,Educational Standard - Holding technical degree/diploma etc,0,0,0,0,0,0,0,0,0,0,0,0,0,0,0
TRIPURA,2004,Educational Standard,540,14,554,698,10,708,0,0,0,3,0,3,1241,24,1265
TRIPURA,2004,Educational Standard - Illiterate,139,2,141,187,4,191,0,0,0,1,0,1,327,6,333
TRIPURA,2004,Educational Standard - Below Class X,355,7,362,486,4,490,0,0,0,2,0,2,843,11,854
TRIPURA,2004,Educational Standard - Class X and above but below graduate,35,5,40,20,2,22,0,0,0,0,0,0,55,7,62
TRIPURA,2004,Educational Standard - Graduate,10,0,10,5,0,5,0,0,0,0,0,0,15,0,15
TRIPURA,2004,Educational Standard - Post-Graduate,1,0,1,0,0,0,0,0,0,0,0,0,1,0,1
TRIPURA,2004,Educational Standard - Holding technical degree/diploma etc,0,0,0,0,0,0,0,0,0,0,0,0,0,0,0
TRIPURA,2005,Educational Standard,737,15,752,635,21,656,1,0,1,1,0,1,1374,36,1410
TRIPURA,2005,Educational Standard - Illiterate,10,5,15,114,6,120,1,0,1,1,0,1,126,11,137
TRIPURA,2005,Educational Standard - Below Class X,644,10,654,441,14,455,0,0,0,0,0,0,1085,24,1109
TRIPURA,2005,Educational Standard - Class X and above but below graduate,65,0,65,72,1,73,0,0,0,0,0,0,137,1,138
TRIPURA,2005,Educational Standard - Graduate,15,0,15,8,0,8,0,0,0,0,0,0,23,0,23
TRIPURA,2005,Educational Standard - Post-Graduate,1,0,1,0,0,0,0,0,0,0,0,0,1,0,1
TRIPURA,2005,Educational Standard - Holding technical degree/diploma etc,2,0,2,0,0,0,0,0,0,0,0,0,2,0,2
TRIPURA,2006,Educational Standard,771,18,789,566,15,581,0,0,0,0,0,0,1337,33,1370
TRIPURA,2006,Educational Standard - Illiterate,93,2,95,135,6,141,0,0,0,0,0,0,228,8,236
TRIPURA,2006,Educational Standard - Below Class X,515,16,531,364,9,373,0,0,0,0,0,0,879,25,904
TRIPURA,2006,Educational Standard - Class X and above but below graduate,147,0,147,59,0,59,0,0,0,0,0,0,206,0,206
TRIPURA,2006,Educational Standard - Graduate,12,0,12,5,0,5,0,0,0,0,0,0,17,0,17
TRIPURA,2006,Educational Standard - Post-Graduate,2,0,2,2,0,2,0,0,0,0,0,0,4,0,4
TRIPURA,2006,Educational Standard - Holding technical degree/diploma etc,2,0,2,1,0,1,0,0,0,0,0,0,3,0,3
TRIPURA,2007,Educational Standard,790,23,813,489,14,503,1,0,1,0,0,0,1280,37,1317
TRIPURA,2007,Educational Standard - Illiterate,104,20,124,116,9,125,0,0,0,0,0,0,220,29,249
TRIPURA,2007,Educational Standard - Below Class X,610,3,613,267,5,272,1,0,1,0,0,0,878,8,886
TRIPURA,2007,Educational Standard - Class X and above but below graduate,61,0,61,74,0,74,0,0,0,0,0,0,135,0,135
TRIPURA,2007,Educational Standard - Graduate,10,0,10,27,0,27,0,0,0,0,0,0,37,0,37
TRIPURA,2007,Educational Standard - Post-Graduate,2,0,2,5,0,5,0,0,0,0,0,0,7,0,7
TRIPURA,2007,Educational Standard - Holding technical degree/diploma etc,3,0,3,0,0,0,0,0,0,0,0,0,3,0,3
TRIPURA,2008,Educational Standard,808,19,827,443,8,451,0,0,0,0,0,0,1251,27,1278
TRIPURA,2008,Educational Standard - Illiterate,131,3,134,100,5,105,0,0,0,0,0,0,231,8,239
TRIPURA,2008,Educational Standard - Below Class X,584,16,600,218,3,221,0,0,0,0,0,0,802,19,821
TRIPURA,2008,Educational Standard - Class X and above but below graduate,82,0,82,62,0,62,0,0,0,0,0,0,144,0,144
TRIPURA,2008,Educational Standard - Graduate,8,0,8,63,0,63,0,0,0,0,0,0,71,0,71
TRIPURA,2008,Educational Standard - Post-Graduate,1,0,1,0,0,0,0,0,0,0,0,0,1,0,1
TRIPURA,2008,Educational Standard - Holding technical degree/diploma etc,2,0,2,0,0,0,0,0,0,0,0,0,2,0,2
TRIPURA,2009,Educational Standard,639,14,653,319,16,335,0,0,0,0,0,0,958,30,988
TRIPURA,2009,Educational Standard - Illiterate,28,7,35,34,2,36,0,0,0,0,0,0,62,9,71
TRIPURA,2009,Educational Standard - Below Class X,350,6,356,260,5,265,0,0,0,0,0,0,610,11,621
TRIPURA,2009,Educational Standard - Class X and above but below graduate,241,1,242,20,9,29,0,0,0,0,0,0,261,10,271
TRIPURA,2009,Educational Standard - Graduate,12,0,12,4,0,4,0,0,0,0,0,0,16,0,16
TRIPURA,2009,Educational Standard - Post-Graduate,3,0,3,0,0,0,0,0,0,0,0,0,3,0,3
TRIPURA,2009,Educational Standard - Holding technical degree/diploma etc,5,0,5,1,0,1,0,0,0,0,0,0,6,0,6
TRIPURA,2010,Educational Standard,591,12,603,338,10,348,0,0,0,0,0,0,929,22,951
TRIPURA,2010,Educational Standard - Illiterate,65,1,66,67,5,72,0,0,0,0,0,0,132,6,138
TRIPURA,2010,Educational Standard - Below Class X,475,9,484,244,5,249,0,0,0,0,0,0,719,14,733
TRIPURA,2010,Educational Standard - Class X and above but below graduate,43,2,45,22,0,22,0,0,0,0,0,0,65,2,67
TRIPURA,2010,Educational Standard - Graduate,6,0,6,4,0,4,0,0,0,0,0,0,10,0,10
TRIPURA,2010,Educational Standard - Post-Graduate,1,0,1,0,0,0,0,0,0,0,0,0,1,0,1
TRIPURA,2010,Educational Standard - Holding technical degree/diploma etc,1,0,1,1,0,1,0,0,0,0,0,0,2,0,2
TRIPURA,2011,Educational Standard,554,15,569,310,20,330,0,0,0,0,0,0,864,35,899
TRIPURA,2011,Educational Standard - Illiterate,82,0,82,68,8,76,0,0,0,0,0,0,150,8,158
TRIPURA,2011,Educational Standard - Below Class X,402,13,415,210,12,222,0,0,0,0,0,0,612,25,637
TRIPURA,2011,Educational Standard - Class X and above but below graduate,62,2,64,27,0,27,0,0,0,0,0,0,89,2,91
TRIPURA,2011,Educational Standard - Graduate,6,0,6,4,0,4,0,0,0,0,0,0,10,0,10
TRIPURA,2011,Educational Standard - Post-Graduate,1,0,1,0,0,0,0,0,0,0,0,0,1,0,1
TRIPURA,2011,Educational Standard - Holding technical degree/diploma etc,1,0,1,1,0,1,0,0,0,0,0,0,2,0,2
TRIPURA,2012,Educational Standard,535,14,549,338,14,352,0,0,0,0,0,0,873,28,901
TRIPURA,2012,Educational Standard - Illiterate,55,4,59,70,8,78,0,0,0,0,0,0,125,12,137
TRIPURA,2012,Educational Standard - Below Class X,387,8,395,170,6,176,0,0,0,0,0,0,557,14,571
TRIPURA,2012,Educational Standard - Class X and above but below graduate,82,1,83,92,0,92,0,0,0,0,0,0,174,1,175
TRIPURA,2012,Educational Standard - Graduate,8,0,8,6,0,6,0,0,0,0,0,0,14,0,14
TRIPURA,2012,Educational Standard - Post-Graduate,1,1,2,0,0,0,0,0,0,0,0,0,1,1,2
TRIPURA,2012,Educational Standard - Holding technical degree/diploma etc,2,0,2,0,0,0,0,0,0,0,0,0,2,0,2
UTTAR PRADESH,2001,Educational Standard,5425,143,5568,45698,1177,46875,504,6,510,339,4,343,51966,1330,53296
UTTAR PRADESH,2001,Educational Standard - Illiterate,1521,99,1620,16610,658,17268,90,3,93,199,3,202,18420,763,19183
UTTAR PRADESH,2001,Educational Standard - Below Class X,2448,23,2471,16434,345,16779,120,2,122,109,1,110,19111,371,19482
UTTAR PRADESH,2001,Educational Standard - Class X and above but below graduate,1012,2,1014,8228,115,8343,40,0,40,28,0,28,9308,117,9425
UTTAR PRADESH,2001,Educational Standard - Graduate,251,4,255,2243,19,2262,27,0,27,3,0,3,2524,23,2547
UTTAR PRADESH,2001,Educational Standard - Post-Graduate,38,0,38,620,5,625,1,0,1,0,0,0,659,5,664
UTTAR PRADESH,2001,Educational Standard - Holding technical degree/diploma etc,155,15,170,1563,35,1598,226,1,227,0,0,0,1944,51,1995
UTTAR PRADESH,2002,Educational Standard,5916,157,6073,43851,1100,44951,1071,7,1078,123,0,123,50961,1264,52225
UTTAR PRADESH,2002,Educational Standard - Illiterate,1960,110,2070,18372,701,19073,496,5,501,84,0,84,20912,816,21728
UTTAR PRADESH,2002,Educational Standard - Below Class X,2384,39,2423,14985,283,15268,349,0,349,24,0,24,17742,322,18064
UTTAR PRADESH,2002,Educational Standard - Class X and above but below graduate,1249,5,1254,7404,89,7493,158,2,160,15,0,15,8826,96,8922
UTTAR PRADESH,2002,Educational Standard - Graduate,248,3,251,2437,27,2464,43,0,43,0,0,0,2728,30,2758
UTTAR PRADESH,2002,Educational Standard - Post-Graduate,65,0,65,578,0,578,23,0,23,0,0,0,666,0,666
UTTAR PRADESH,2002,Educational Standard - Holding technical degree/diploma etc,10,0,10,75,0,75,2,0,2,0,0,0,87,0,87
UTTAR PRADESH,2003,Educational Standard,7013,176,7189,40784,926,41710,1398,19,1417,215,0,215,49410,1121,50531
UTTAR PRADESH,2003,Educational Standard - Illiterate,2396,142,2538,15001,538,15539,469,14,483,91,0,91,17957,694,18651
UTTAR PRADESH,2003,Educational Standard - Below Class X,2567,21,2588,11496,207,11703,392,2,394,83,0,83,14538,230,14768
UTTAR PRADESH,2003,Educational Standard - Class X and above but below graduate,1139,8,1147,5665,73,5738,152,0,152,24,0,24,6980,81,7061
UTTAR PRADESH,2003,Educational Standard - Graduate,326,3,329,2409,3,2412,36,0,36,3,0,3,2774,6,2780
UTTAR PRADESH,2003,Educational Standard - Post-Graduate,135,2,137,1304,22,1326,13,0,13,1,0,1,1453,24,1477
UTTAR PRADESH,2003,Educational Standard - Holding technical degree/diploma etc,450,0,450,4909,83,4992,336,3,339,13,0,13,5708,86,5794
UTTAR PRADESH,2004,Educational Standard,8114,197,8311,40343,881,41224,1980,73,2053,117,1,118,50554,1152,51706
UTTAR PRADESH,2004,Educational Standard - Illiterate,2851,152,3003,18403,559,18962,895,61,956,59,1,60,22208,773,22981
UTTAR PRADESH,2004,Educational Standard - Below Class X,3529,36,3565,12717,240,12957,512,9,521,57,0,57,16815,285,17100
UTTAR PRADESH,2004,Educational Standard - Class X and above but below graduate,1294,4,1298,6437,70,6507,533,3,536,1,0,1,8265,77,8342
UTTAR PRADESH,2004,Educational Standard - Graduate,341,5,346,2132,11,2143,38,0,38,0,0,0,2511,16,2527
UTTAR PRADESH,2004,Educational Standard - Post-Graduate,85,0,85,496,1,497,2,0,2,0,0,0,583,1,584
UTTAR PRADESH,2004,Educational Standard - Holding technical degree/diploma etc,14,0,14,158,0,158,0,0,0,0,0,0,172,0,172
UTTAR PRADESH,2005,Educational Standard,12991,293,13284,42029,1049,43078,248,1,249,107,0,107,55375,1343,56718
UTTAR PRADESH,2005,Educational Standard - Illiterate,4223,197,4420,18422,741,19163,107,1,108,91,0,91,22843,939,23782
UTTAR PRADESH,2005,Educational Standard - Below Class X,5030,73,5103,14795,220,15015,99,0,99,15,0,15,19939,293,20232
UTTAR PRADESH,2005,Educational Standard - Class X and above but below graduate,2401,17,2418,5347,62,5409,20,0,20,1,0,1,7769,79,7848
UTTAR PRADESH,2005,Educational Standard - Graduate,1044,4,1048,2012,17,2029,14,0,14,0,0,0,3070,21,3091
UTTAR PRADESH,2005,Educational Standard - Post-Graduate,187,0,187,386,2,388,4,0,4,0,0,0,577,2,579
UTTAR PRADESH,2005,Educational Standard - Holding technical degree/diploma etc,106,2,108,1067,7,1074,4,0,4,0,0,0,1177,9,1186
UTTAR PRADESH,2006,Educational Standard,15812,477,16289,48694,1469,50163,192,1,193,24,0,24,64722,1947,66669
UTTAR PRADESH,2006,Educational Standard - Illiterate,6123,314,6437,22221,866,23087,185,1,186,24,0,24,28553,1181,29734
UTTAR PRADESH,2006,Educational Standard - Below Class X,5395,126,5521,16844,446,17290,7,0,7,0,0,0,22246,572,22818
UTTAR PRADESH,2006,Educational Standard - Class X and above but below graduate,2938,30,2968,6119,122,6241,0,0,0,0,0,0,9057,152,9209
UTTAR PRADESH,2006,Educational Standard - Graduate,965,7,972,2378,30,2408,0,0,0,0,0,0,3343,37,3380
UTTAR PRADESH,2006,Educational Standard - Post-Graduate,344,0,344,948,5,953,0,0,0,0,0,0,1292,5,1297
UTTAR PRADESH,2006,Educational Standard - Holding technical degree/diploma etc,47,0,47,184,0,184,0,0,0,0,0,0,231,0,231
UTTAR PRADESH,2007,Educational Standard,19114,579,19693,52296,1696,53992,2244,53,2297,197,1,198,73851,2329,76180
UTTAR PRADESH,2007,Educational Standard - Illiterate,6142,358,6500,22324,1056,23380,850,24,874,105,1,106,29421,1439,30860
UTTAR PRADESH,2007,Educational Standard - Below Class X,5567,160,5727,18071,445,18516,881,20,901,42,0,42,24561,625,25186
UTTAR PRADESH,2007,Educational Standard - Class X and above but below graduate,3402,51,3453,8135,159,8294,345,9,354,26,0,26,11908,219,12127
UTTAR PRADESH,2007,Educational Standard - Graduate,916,6,922,2546,28,2574,79,0,79,11,0,11,3552,34,3586
UTTAR PRADESH,2007,Educational Standard - Post-Graduate,327,3,330,926,8,934,40,0,40,13,0,13,1306,11,1317
UTTAR PRADESH,2007,Educational Standard - Holding technical degree/diploma etc,2760,1,2761,294,0,294,49,0,49,0,0,0,3103,1,3104
UTTAR PRADESH,2008,Educational Standard,21002,673,21675,56478,2020,58498,608,0,608,27,1,28,78115,2694,80809
UTTAR PRADESH,2008,Educational Standard - Illiterate,7590,425,8015,23566,1217,24783,235,0,235,11,1,12,31402,1643,33045
UTTAR PRADESH,2008,Educational Standard - Below Class X,7494,164,7658,18224,508,18732,204,0,204,7,0,7,25929,672,26601
UTTAR PRADESH,2008,Educational Standard - Class X and above but below graduate,4244,66,4310,9026,187,9213,126,0,126,9,0,9,13405,253,13658
UTTAR PRADESH,2008,Educational Standard - Graduate,1177,6,1183,3000,30,3030,26,0,26,0,0,0,4203,36,4239
UTTAR PRADESH,2008,Educational Standard - Post-Graduate,285,2,287,1095,13,1108,8,0,8,0,0,0,1388,15,1403
UTTAR PRADESH,2008,Educational Standard - Holding technical degree/diploma etc,212,10,222,1567,65,1632,9,0,9,0,0,0,1788,75,1863
UTTAR PRADESH,2009,Educational Standard,23714,716,24430,57017,2041,59058,292,2,294,23,0,23,81046,2759,83805
UTTAR PRADESH,2009,Educational Standard - Illiterate,8168,462,8630,19761,1110,20871,116,2,118,11,0,11,28056,1574,29630
UTTAR PRADESH,2009,Educational Standard - Below Class X,8938,190,9128,21229,663,21892,92,0,92,3,0,3,30262,853,31115
UTTAR PRADESH,2009,Educational Standard - Class X and above but below graduate,4984,52,5036,11030,215,11245,54,0,54,9,0,9,16077,267,16344
UTTAR PRADESH,2009,Educational Standard - Graduate,1242,11,1253,3419,40,3459,22,0,22,0,0,0,4683,51,4734
UTTAR PRADESH,2009,Educational Standard - Post-Graduate,320,1,321,1262,12,1274,8,0,8,0,0,0,1590,13,1603
UTTAR PRADESH,2009,Educational Standard - Holding technical degree/diploma etc,62,0,62,316,1,317,0,0,0,0,0,0,378,1,379
UTTAR PRADESH,2010,Educational Standard,25734,799,26533,54040,1832,55872,238,0,238,30,0,30,80042,2631,82673
UTTAR PRADESH,2010,Educational Standard - Illiterate,9168,542,9710,18203,1009,19212,91,0,91,15,0,15,27477,1551,29028
UTTAR PRADESH,2010,Educational Standard - Below Class X,9963,193,10156,20223,554,20777,78,0,78,5,0,5,30269,747,31016
UTTAR PRADESH,2010,Educational Standard - Class X and above but below graduate,4984,52,5036,11030,216,11246,48,0,48,10,0,10,16072,268,16340
UTTAR PRADESH,2010,Educational Standard - Graduate,1237,11,1248,3218,40,3258,16,0,16,0,0,0,4471,51,4522
UTTAR PRADESH,2010,Educational Standard - Post-Graduate,320,1,321,1050,12,1062,5,0,5,0,0,0,1375,13,1388
UTTAR PRADESH,2010,Educational Standard - Holding technical degree/diploma etc,62,0,62,316,1,317,0,0,0,0,0,0,378,1,379
UTTAR PRADESH,2011,Educational Standard,27146,905,28051,51828,2234,54062,213,0,213,57,0,57,79244,3139,82383
UTTAR PRADESH,2011,Educational Standard - Illiterate,9555,594,10149,17612,1127,18739,89,0,89,27,0,27,27283,1721,29004
UTTAR PRADESH,2011,Educational Standard - Below Class X,10364,224,10588,19813,644,20457,73,0,73,8,0,8,30258,868,31126
UTTAR PRADESH,2011,Educational Standard - Class X and above but below graduate,5324,68,5392,10625,336,10961,36,0,36,22,0,22,16007,404,16411
UTTAR PRADESH,2011,Educational Standard - Graduate,1408,17,1425,2738,87,2825,12,0,12,0,0,0,4158,104,4262
UTTAR PRADESH,2011,Educational Standard - Post-Graduate,403,2,405,736,37,773,3,0,3,0,0,0,1142,39,1181
UTTAR PRADESH,2011,Educational Standard - Holding technical degree/diploma etc,92,0,92,304,3,307,0,0,0,0,0,0,396,3,399
UTTAR PRADESH,2012,Educational Standard,25406,844,26250,51502,2319,53821,197,0,197,43,0,43,77148,3163,80311
UTTAR PRADESH,2012,Educational Standard - Illiterate,9053,561,9614,17401,1167,18568,84,0,84,21,0,21,26559,1728,28287
UTTAR PRADESH,2012,Educational Standard - Below Class X,9663,203,9866,19725,665,20390,69,0,69,7,0,7,29464,868,30332
UTTAR PRADESH,2012,Educational Standard - Class X and above but below graduate,5004,62,5066,10615,344,10959,33,0,33,15,0,15,15667,406,16073
UTTAR PRADESH,2012,Educational Standard - Graduate,1203,15,1218,2731,93,2824,9,0,9,0,0,0,3943,108,4051
UTTAR PRADESH,2012,Educational Standard - Post-Graduate,395,3,398,731,45,776,2,0,2,0,0,0,1128,48,1176
UTTAR PRADESH,2012,Educational Standard - Holding technical degree/diploma etc,88,0,88,299,5,304,0,0,0,0,0,0,387,5,392
UTTARANCHAL,2001,Educational Standard,506,3,509,1718,63,1781,0,0,0,0,0,0,2224,66,2290
UTTARANCHAL,2001,Educational Standard - Illiterate,128,3,131,709,38,747,0,0,0,0,0,0,837,41,878
UTTARANCHAL,2001,Educational Standard - Below Class X,214,0,214,495,18,513,0,0,0,0,0,0,709,18,727
UTTARANCHAL,2001,Educational Standard - Class X and above but below graduate,142,0,142,427,7,434,0,0,0,0,0,0,569,7,576
UTTARANCHAL,2001,Educational Standard - Graduate,13,0,13,58,0,58,0,0,0,0,0,0,71,0,71
UTTARANCHAL,2001,Educational Standard - Post-Graduate,9,0,9,23,0,23,0,0,0,0,0,0,32,0,32
UTTARANCHAL,2001,Educational Standard - Holding technical degree/diploma etc,0,0,0,6,0,6,0,0,0,0,0,0,6,0,6
UTTARANCHAL,2002,Educational Standard,645,12,657,1652,50,1702,0,0,0,0,0,0,2297,62,2359
UTTARANCHAL,2002,Educational Standard - Illiterate,167,9,176,800,24,824,0,0,0,0,0,0,967,33,1000
UTTARANCHAL,2002,Educational Standard - Below Class X,258,3,261,602,20,622,0,0,0,0,0,0,860,23,883
UTTARANCHAL,2002,Educational Standard - Class X and above but below graduate,185,0,185,152,6,158,0,0,0,0,0,0,337,6,343
UTTARANCHAL,2002,Educational Standard - Graduate,19,0,19,80,0,80,0,0,0,0,0,0,99,0,99
UTTARANCHAL,2002,Educational Standard - Post-Graduate,16,0,16,18,0,18,0,0,0,0,0,0,34,0,34
UTTARANCHAL,2002,Educational Standard - Holding technical degree/diploma etc,0,0,0,0,0,0,0,0,0,0,0,0,0,0,0
UTTARANCHAL,2003,Educational Standard,693,12,705,1672,47,1719,5,0,5,2,0,2,2372,59,2431
UTTARANCHAL,2003,Educational Standard - Illiterate,165,8,173,500,26,526,0,0,0,2,0,2,667,34,701
UTTARANCHAL,2003,Educational Standard - Below Class X,337,4,341,697,18,715,5,0,5,0,0,0,1039,22,1061
UTTARANCHAL,2003,Educational Standard - Class X and above but below graduate,161,0,161,439,3,442,0,0,0,0,0,0,600,3,603
UTTARANCHAL,2003,Educational Standard - Graduate,21,0,21,23,0,23,0,0,0,0,0,0,44,0,44
UTTARANCHAL,2003,Educational Standard - Post-Graduate,9,0,9,10,0,10,0,0,0,0,0,0,19,0,19
UTTARANCHAL,2003,Educational Standard - Holding technical degree/diploma etc,0,0,0,3,0,3,0,0,0,0,0,0,3,0,3
UTTARANCHAL,2004,Educational Standard,729,21,750,1527,83,1610,5,0,5,0,0,0,2261,104,2365
UTTARANCHAL,2004,Educational Standard - Illiterate,209,8,217,176,42,218,0,0,0,0,0,0,385,50,435
UTTARANCHAL,2004,Educational Standard - Below Class X,257,6,263,732,26,758,2,0,2,0,0,0,991,32,1023
UTTARANCHAL,2004,Educational Standard - Class X and above but below graduate,240,7,247,456,12,468,3,0,3,0,0,0,699,19,718
UTTARANCHAL,2004,Educational Standard - Graduate,12,0,12,42,3,45,0,0,0,0,0,0,54,3,57
UTTARANCHAL,2004,Educational Standard - Post-Graduate,4,0,4,65,0,65,0,0,0,0,0,0,69,0,69
UTTARANCHAL,2004,Educational Standard - Holding technical degree/diploma etc,7,0,7,56,0,56,0,0,0,0,0,0,63,0,63
UTTARANCHAL,2005,Educational Standard,751,14,765,1544,34,1578,2,0,2,5,0,5,2302,48,2350
UTTARANCHAL,2005,Educational Standard - Illiterate,95,6,101,325,16,341,0,0,0,0,0,0,420,22,442
UTTARANCHAL,2005,Educational Standard - Below Class X,403,7,410,813,16,829,2,0,2,5,0,5,1223,23,1246
UTTARANCHAL,2005,Educational Standard - Class X and above but below graduate,183,1,184,349,2,351,0,0,0,0,0,0,532,3,535
UTTARANCHAL,2005,Educational Standard - Graduate,44,0,44,42,0,42,0,0,0,0,0,0,86,0,86
UTTARANCHAL,2005,Educational Standard - Post-Graduate,25,0,25,11,0,11,0,0,0,0,0,0,36,0,36
UTTARANCHAL,2005,Educational Standard - Holding technical degree/diploma etc,1,0,1,4,0,4,0,0,0,0,0,0,5,0,5
UTTARANCHAL,2006,Educational Standard,890,17,907,1685,52,1737,0,0,0,0,0,0,2575,69,2644
UTTARANCHAL,2006,Educational Standard - Illiterate,299,7,306,473,18,491,0,0,0,0,0,0,772,25,797
UTTARANCHAL,2006,Educational Standard - Below Class X,301,7,308,633,25,658,0,0,0,0,0,0,934,32,966
UTTARANCHAL,2006,Educational Standard - Class X and above but below graduate,194,3,197,427,9,436,0,0,0,0,0,0,621,12,633
UTTARANCHAL,2006,Educational Standard - Graduate,58,0,58,81,0,81,0,0,0,0,0,0,139,0,139
UTTARANCHAL,2006,Educational Standard - Post-Graduate,34,0,34,37,0,37,0,0,0,0,0,0,71,0,71
UTTARANCHAL,2006,Educational Standard - Holding technical degree/diploma etc,4,0,4,34,0,34,0,0,0,0,0,0,38,0,38
UTTARANCHAL,2007,Educational Standard,1020,28,1048,1607,54,1661,0,0,0,0,0,0,2627,82,2709
UTTARANCHAL,2007,Educational Standard - Illiterate,296,13,309,386,17,403,0,0,0,0,0,0,682,30,712
UTTARANCHAL,2007,Educational Standard - Below Class X,435,12,447,831,33,864,0,0,0,0,0,0,1266,45,1311
UTTARANCHAL,2007,Educational Standard - Class X and above but below graduate,188,3,191,307,4,311,0,0,0,0,0,0,495,7,502
UTTARANCHAL,2007,Educational Standard - Graduate,64,0,64,56,0,56,0,0,0,0,0,0,120,0,120
UTTARANCHAL,2007,Educational Standard - Post-Graduate,23,0,23,14,0,14,0,0,0,0,0,0,37,0,37
UTTARANCHAL,2007,Educational Standard - Holding technical degree/diploma etc,14,0,14,13,0,13,0,0,0,0,0,0,27,0,27
UTTARANCHAL,2008,Educational Standard,1187,35,1222,1927,85,2012,0,0,0,0,0,0,3114,120,3234
UTTARANCHAL,2008,Educational Standard - Illiterate,325,2,327,695,37,732,0,0,0,0,0,0,1020,39,1059
UTTARANCHAL,2008,Educational Standard - Below Class X,425,8,433,317,28,345,0,0,0,0,0,0,742,36,778
UTTARANCHAL,2008,Educational Standard - Class X and above but below graduate,300,17,317,670,11,681,0,0,0,0,0,0,970,28,998
UTTARANCHAL,2008,Educational Standard - Graduate,87,6,93,135,8,143,0,0,0,0,0,0,222,14,236
UTTARANCHAL,2008,Educational Standard - Post-Graduate,40,2,42,70,1,71,0,0,0,0,0,0,110,3,113
UTTARANCHAL,2008,Educational Standard - Holding technical degree/diploma etc,10,0,10,40,0,40,0,0,0,0,0,0,50,0,50
UTTARANCHAL,2009,Educational Standard,1239,44,1283,2148,76,2224,0,0,0,0,0,0,3387,120,3507
UTTARANCHAL,2009,Educational Standard - Illiterate,413,20,433,419,28,447,0,0,0,0,0,0,832,48,880
UTTARANCHAL,2009,Educational Standard - Below Class X,414,19,433,1143,41,1184,0,0,0,0,0,0,1557,60,1617
UTTARANCHAL,2009,Educational Standard - Class X and above but below graduate,347,5,352,470,5,475,0,0,0,0,0,0,817,10,827
UTTARANCHAL,2009,Educational Standard - Graduate,40,0,40,78,2,80,0,0,0,0,0,0,118,2,120
UTTARANCHAL,2009,Educational Standard - Post-Graduate,17,0,17,25,0,25,0,0,0,0,0,0,42,0,42
UTTARANCHAL,2009,Educational Standard - Holding technical degree/diploma etc,8,0,8,13,0,13,0,0,0,0,0,0,21,0,21
UTTARANCHAL,2010,Educational Standard,1400,56,1456,2029,58,2087,0,0,0,0,0,0,3429,114,3543
UTTARANCHAL,2010,Educational Standard - Illiterate,372,18,390,502,21,523,0,0,0,0,0,0,874,39,913
UTTARANCHAL,2010,Educational Standard - Below Class X,556,30,586,918,31,949,0,0,0,0,0,0,1474,61,1535
UTTARANCHAL,2010,Educational Standard - Class X and above but below graduate,410,8,418,473,6,479,0,0,0,0,0,0,883,14,897
UTTARANCHAL,2010,Educational Standard - Graduate,45,0,45,118,0,118,0,0,0,0,0,0,163,0,163
UTTARANCHAL,2010,Educational Standard - Post-Graduate,11,0,11,13,0,13,0,0,0,0,0,0,24,0,24
UTTARANCHAL,2010,Educational Standard - Holding technical degree/diploma etc,6,0,6,5,0,5,0,0,0,0,0,0,11,0,11
UTTARANCHAL,2011,Educational Standard,1486,67,1553,1640,68,1708,0,0,0,0,0,0,3126,135,3261
UTTARANCHAL,2011,Educational Standard - Illiterate,549,22,571,628,28,656,0,0,0,0,0,0,1177,50,1227
UTTARANCHAL,2011,Educational Standard - Below Class X,430,30,460,456,25,481,0,0,0,0,0,0,886,55,941
UTTARANCHAL,2011,Educational Standard - Class X and above but below graduate,412,6,418,437,7,444,0,0,0,0,0,0,849,13,862
UTTARANCHAL,2011,Educational Standard - Graduate,58,7,65,70,4,74,0,0,0,0,0,0,128,11,139
UTTARANCHAL,2011,Educational Standard - Post-Graduate,30,2,32,40,3,43,0,0,0,0,0,0,70,5,75
UTTARANCHAL,2011,Educational Standard - Holding technical degree/diploma etc,7,0,7,9,1,10,0,0,0,0,0,0,16,1,17
UTTARANCHAL,2012,Educational Standard,1605,68,1673,1781,81,1862,0,0,0,0,0,0,3386,149,3535
UTTARANCHAL,2012,Educational Standard - Illiterate,498,19,517,595,26,621,0,0,0,0,0,0,1093,45,1138
UTTARANCHAL,2012,Educational Standard - Below Class X,510,31,541,538,35,573,0,0,0,0,0,0,1048,66,1114
UTTARANCHAL,2012,Educational Standard - Class X and above but below graduate,482,7,489,510,9,519,0,0,0,0,0,0,992,16,1008
UTTARANCHAL,2012,Educational Standard - Graduate,69,8,77,79,5,84,0,0,0,0,0,0,148,13,161
UTTARANCHAL,2012,Educational Standard - Post-Graduate,37,3,40,48,4,52,0,0,0,0,0,0,85,7,92
UTTARANCHAL,2012,Educational Standard - Holding technical degree/diploma etc,9,0,9,11,2,13,0,0,0,0,0,0,20,2,22
WEST BENGAL,2001,Educational Standard,2401,106,2507,9293,429,9722,21,1,22,96,0,96,11811,536,12347
WEST BENGAL,2001,Educational Standard - Illiterate,934,46,980,4161,236,4397,7,0,7,69,0,69,5171,282,5453
WEST BENGAL,2001,Educational Standard - Below Class X,1104,40,1144,4135,170,4305,12,1,13,27,0,27,5278,211,5489
WEST BENGAL,2001,Educational Standard - Class X and above but below graduate,269,19,288,842,19,861,1,0,1,0,0,0,1112,38,1150
WEST BENGAL,2001,Educational Standard - Graduate,70,1,71,139,4,143,1,0,1,0,0,0,210,5,215
WEST BENGAL,2001,Educational Standard - Post-Graduate,17,0,17,0,0,0,0,0,0,0,0,0,17,0,17
WEST BENGAL,2001,Educational Standard - Holding technical degree/diploma etc,7,0,7,16,0,16,0,0,0,0,0,0,23,0,23
WEST BENGAL,2002,Educational Standard,2472,139,2611,15314,722,16036,1,0,1,94,1,95,17881,862,18743
WEST BENGAL,2002,Educational Standard - Illiterate,1030,103,1133,7008,442,7450,0,0,0,76,0,76,8114,545,8659
WEST BENGAL,2002,Educational Standard - Below Class X,1028,24,1052,6560,240,6800,1,0,1,16,1,17,7605,265,7870
WEST BENGAL,2002,Educational Standard - Class X and above but below graduate,360,10,370,1477,39,1516,0,0,0,2,0,2,1839,49,1888
WEST BENGAL,2002,Educational Standard - Graduate,49,2,51,229,1,230,0,0,0,0,0,0,278,3,281
WEST BENGAL,2002,Educational Standard - Post-Graduate,3,0,3,13,0,13,0,0,0,0,0,0,16,0,16
WEST BENGAL,2002,Educational Standard - Holding technical degree/diploma etc,2,0,2,27,0,27,0,0,0,0,0,0,29,0,29
WEST BENGAL,2003,Educational Standard,3182,268,3450,12134,623,12757,3,0,3,79,0,79,15398,891,16289
WEST BENGAL,2003,Educational Standard - Illiterate,1367,181,1548,5789,328,6117,0,0,0,55,0,55,7211,509,7720
WEST BENGAL,2003,Educational Standard - Below Class X,1284,77,1361,4898,215,5113,0,0,0,20,0,20,6202,292,6494
WEST BENGAL,2003,Educational Standard - Class X and above but below graduate,419,8,427,1157,68,1225,3,0,3,1,0,1,1580,76,1656
WEST BENGAL,2003,Educational Standard - Graduate,103,2,105,271,12,283,0,0,0,3,0,3,377,14,391
WEST BENGAL,2003,Educational Standard - Post-Graduate,5,0,5,14,0,14,0,0,0,0,0,0,19,0,19
WEST BENGAL,2003,Educational Standard - Holding technical degree/diploma etc,4,0,4,5,0,5,0,0,0,0,0,0,9,0,9
WEST BENGAL,2004,Educational Standard,3334,186,3520,12102,688,12790,0,0,0,6,3,9,15442,877,16319
WEST BENGAL,2004,Educational Standard - Illiterate,1317,96,1413,4971,387,5358,0,0,0,3,3,6,6291,486,6777
WEST BENGAL,2004,Educational Standard - Below Class X,1366,72,1438,5404,246,5650,0,0,0,0,0,0,6770,318,7088
WEST BENGAL,2004,Educational Standard - Class X and above but below graduate,480,14,494,1426,51,1477,0,0,0,3,0,3,1909,65,1974
WEST BENGAL,2004,Educational Standard - Graduate,163,4,167,277,4,281,0,0,0,0,0,0,440,8,448
WEST BENGAL,2004,Educational Standard - Post-Graduate,7,0,7,17,0,17,0,0,0,0,0,0,24,0,24
WEST BENGAL,2004,Educational Standard - Holding technical degree/diploma etc,1,0,1,7,0,7,0,0,0,0,0,0,8,0,8
WEST BENGAL,2005,Educational Standard,3628,220,3848,13005,1012,14017,56,2,58,209,26,235,16898,1260,18158
WEST BENGAL,2005,Educational Standard - Illiterate,1280,98,1378,4712,527,5239,0,0,0,58,17,75,6050,642,6692
WEST BENGAL,2005,Educational Standard - Below Class X,1521,97,1618,6219,362,6581,21,0,21,121,9,130,7882,468,8350
WEST BENGAL,2005,Educational Standard - Class X and above but below graduate,504,21,525,1690,116,1806,25,1,26,26,0,26,2245,138,2383
WEST BENGAL,2005,Educational Standard - Graduate,301,4,305,352,7,359,8,0,8,4,0,4,665,11,676
WEST BENGAL,2005,Educational Standard - Post-Graduate,20,0,20,27,0,27,2,1,3,0,0,0,49,1,50
WEST BENGAL,2005,Educational Standard - Holding technical degree/diploma etc,2,0,2,5,0,5,0,0,0,0,0,0,7,0,7
WEST BENGAL,2006,Educational Standard,3647,229,3876,13289,803,14092,0,0,0,205,20,225,17141,1052,18193
WEST BENGAL,2006,Educational Standard - Illiterate,567,71,638,3685,386,4071,0,0,0,121,12,133,4373,469,4842
WEST BENGAL,2006,Educational Standard - Below Class X,2329,122,2451,7627,349,7976,0,0,0,76,7,83,10032,478,10510
WEST BENGAL,2006,Educational Standard - Class X and above but below graduate,564,27,591,1533,55,1588,0,0,0,6,1,7,2103,83,2186
WEST BENGAL,2006,Educational Standard - Graduate,163,8,171,358,12,370,0,0,0,2,0,2,523,20,543
WEST BENGAL,2006,Educational Standard - Post-Graduate,21,0,21,71,1,72,0,0,0,0,0,0,92,1,93
WEST BENGAL,2006,Educational Standard - Holding technical degree/diploma etc,3,1,4,15,0,15,0,0,0,0,0,0,18,1,19
WEST BENGAL,2007,Educational Standard,4134,211,4345,12959,1002,13961,0,0,0,239,53,292,17332,1266,18598
WEST BENGAL,2007,Educational Standard - Illiterate,1303,42,1345,3514,444,3958,0,0,0,93,29,122,4910,515,5425
WEST BENGAL,2007,Educational Standard - Below Class X,2160,130,2290,7582,499,8081,0,0,0,144,24,168,9886,653,10539
WEST BENGAL,2007,Educational Standard - Class X and above but below graduate,565,36,601,1485,51,1536,0,0,0,2,0,2,2052,87,2139
WEST BENGAL,2007,Educational Standard - Graduate,95,2,97,334,6,340,0,0,0,0,0,0,429,8,437
WEST BENGAL,2007,Educational Standard - Post-Graduate,6,0,6,26,1,27,0,0,0,0,0,0,32,1,33
WEST BENGAL,2007,Educational Standard - Holding technical degree/diploma etc,5,1,6,18,1,19,0,0,0,0,0,0,23,2,25
WEST BENGAL,2008,Educational Standard,5637,344,5981,13059,1052,14111,0,0,0,111,27,138,18807,1423,20230
WEST BENGAL,2008,Educational Standard - Illiterate,1821,189,2010,4925,620,5545,0,0,0,43,13,56,6789,822,7611
WEST BENGAL,2008,Educational Standard - Below Class X,2821,131,2952,6202,334,6536,0,0,0,68,13,81,9091,478,9569
WEST BENGAL,2008,Educational Standard - Class X and above but below graduate,746,17,763,1458,79,1537,0,0,0,0,0,0,2204,96,2300
WEST BENGAL,2008,Educational Standard - Graduate,224,6,230,397,17,414,0,0,0,0,1,1,621,24,645
WEST BENGAL,2008,Educational Standard - Post-Graduate,15,1,16,36,2,38,0,0,0,0,0,0,51,3,54
WEST BENGAL,2008,Educational Standard - Holding technical degree/diploma etc,10,0,10,41,0,41,0,0,0,0,0,0,51,0,51
WEST BENGAL,2009,Educational Standard,5514,405,5919,10774,691,11465,1,2,3,182,17,199,16471,1115,17586
WEST BENGAL,2009,Educational Standard - Illiterate,1721,218,1939,3661,377,4038,0,2,2,110,12,122,5492,609,6101
WEST BENGAL,2009,Educational Standard - Below Class X,3018,155,3173,5415,262,5677,1,0,1,72,5,77,8506,422,8928
WEST BENGAL,2009,Educational Standard - Class X and above but below graduate,585,24,609,1350,38,1388,0,0,0,0,0,0,1935,62,1997
WEST BENGAL,2009,Educational Standard - Graduate,164,6,170,285,10,295,0,0,0,0,0,0,449,16,465
WEST BENGAL,2009,Educational Standard - Post-Graduate,16,2,18,34,4,38,0,0,0,0,0,0,50,6,56
WEST BENGAL,2009,Educational Standard - Holding technical degree/diploma etc,10,0,10,29,0,29,0,0,0,0,0,0,39,0,39
WEST BENGAL,2010,Educational Standard,5397,381,5778,11625,736,12361,1,0,1,343,36,379,17366,1153,18519
WEST BENGAL,2010,Educational Standard - Illiterate,2432,225,2657,3929,405,4334,0,0,0,275,26,301,6636,656,7292
WEST BENGAL,2010,Educational Standard - Below Class X,2112,127,2239,5480,250,5730,1,0,1,68,10,78,7661,387,8048
WEST BENGAL,2010,Educational Standard - Class X and above but below graduate,663,20,683,1671,71,1742,0,0,0,0,0,0,2334,91,2425
WEST BENGAL,2010,Educational Standard - Graduate,150,9,159,476,10,486,0,0,0,0,0,0,626,19,645
WEST BENGAL,2010,Educational Standard - Post-Graduate,22,0,22,44,0,44,0,0,0,0,0,0,66,0,66
WEST BENGAL,2010,Educational Standard - Holding technical degree/diploma etc,18,0,18,25,0,25,0,0,0,0,0,0,43,0,43
WEST BENGAL,2011,Educational Standard,5298,362,5660,12804,763,13567,5,0,5,244,32,276,18351,1157,19508
WEST BENGAL,2011,Educational Standard - Illiterate,1598,187,1785,4297,382,4679,1,0,1,154,18,172,6050,587,6637
WEST BENGAL,2011,Educational Standard - Below Class X,2691,132,2823,5842,289,6131,2,0,2,65,13,78,8600,434,9034
WEST BENGAL,2011,Educational Standard - Class X and above but below graduate,823,35,858,2139,67,2206,2,0,2,25,1,26,2989,103,3092
WEST BENGAL,2011,Educational Standard - Graduate,165,6,171,426,20,446,0,0,0,0,0,0,591,26,617
WEST BENGAL,2011,Educational Standard - Post-Graduate,11,2,13,60,5,65,0,0,0,0,0,0,71,7,78
WEST BENGAL,2011,Educational Standard - Holding technical degree/diploma etc,10,0,10,40,0,40,0,0,0,0,0,0,50,0,50
WEST BENGAL,2012,Educational Standard,5767,404,6171,13106,871,13977,3,0,3,240,40,280,19116,1315,20431
WEST BENGAL,2012,Educational Standard - Illiterate,1925,193,2118,4135,370,4505,1,0,1,70,18,88,6131,581,6712
WEST BENGAL,2012,Educational Standard - Below Class X,2905,150,3055,7045,443,7488,1,0,1,110,15,125,10061,608,10669
WEST BENGAL,2012,Educational Standard - Class X and above but below graduate,722,36,758,1464,45,1509,1,0,1,49,4,53,2236,85,2321
WEST BENGAL,2012,Educational Standard - Graduate,164,19,183,376,7,383,0,0,0,6,1,7,546,27,573
WEST BENGAL,2012,Educational Standard - Post-Graduate,35,3,38,54,4,58,0,0,0,2,1,3,91,8,99
WEST BENGAL,2012,Educational Standard - Holding technical degree/diploma etc,16,3,19,32,2,34,0,0,0,3,1,4,51,6,57
A & N ISLANDS,2001,Educational Standard,214,3,217,165,1,166,0,0,0,0,0,0,379,4,383
A & N ISLANDS,2001,Educational Standard - Illiterate,0,0,0,0,0,0,0,0,0,0,0,0,0,0,0
A & N ISLANDS,2001,Educational Standard - Below Class X,14,0,14,8,0,8,0,0,0,0,0,0,22,0,22
A & N ISLANDS,2001,Educational Standard - Class X and above but below graduate,153,2,155,112,1,113,0,0,0,0,0,0,265,3,268
A & N ISLANDS,2001,Educational Standard - Graduate,43,0,43,39,0,39,0,0,0,0,0,0,82,0,82
A & N ISLANDS,2001,Educational Standard - Post-Graduate,4,1,5,6,0,6,0,0,0,0,0,0,10,1,11
A & N ISLANDS,2001,Educational Standard - Holding technical degree/diploma etc,0,0,0,0,0,0,0,0,0,0,0,0,0,0,0
A & N ISLANDS,2002,Educational Standard,133,4,137,190,4,194,0,0,0,0,0,0,323,8,331
A & N ISLANDS,2002,Educational Standard - Illiterate,0,0,0,0,0,0,0,0,0,0,0,0,0,0,0
A & N ISLANDS,2002,Educational Standard - Below Class X,18,1,19,30,4,34,0,0,0,0,0,0,48,5,53
A & N ISLANDS,2002,Educational Standard - Class X and above but below graduate,73,2,75,125,0,125,0,0,0,0,0,0,198,2,200
A & N ISLANDS,2002,Educational Standard - Graduate,38,0,38,32,0,32,0,0,0,0,0,0,70,0,70
A & N ISLANDS,2002,Educational Standard - Post-Graduate,4,1,5,3,0,3,0,0,0,0,0,0,7,1,8
A & N ISLANDS,2002,Educational Standard - Holding technical degree/diploma etc,0,0,0,0,0,0,0,0,0,0,0,0,0,0,0
A & N ISLANDS,2003,Educational Standard,90,2,92,203,1,204,0,0,0,0,0,0,293,3,296
A & N ISLANDS,2003,Educational Standard - Illiterate,3,0,3,23,0,23,0,0,0,0,0,0,26,0,26
A & N ISLANDS,2003,Educational Standard - Below Class X,75,1,76,178,1,179,0,0,0,0,0,0,253,2,255
A & N ISLANDS,2003,Educational Standard - Class X and above but below graduate,10,0,10,2,0,2,0,0,0,0,0,0,12,0,12
A & N ISLANDS,2003,Educational Standard - Graduate,2,1,3,0,0,0,0,0,0,0,0,0,2,1,3
A & N ISLANDS,2003,Educational Standard - Post-Graduate,0,0,0,0,0,0,0,0,0,0,0,0,0,0,0
A & N ISLANDS,2003,Educational Standard - Holding technical degree/diploma etc,0,0,0,0,0,0,0,0,0,0,0,0,0,0,0
A & N ISLANDS,2004,Educational Standard,54,2,56,164,1,165,0,0,0,0,0,0,218,3,221
A & N ISLANDS,2004,Educational Standard - Illiterate,0,0,0,5,0,5,0,0,0,0,0,0,5,0,5
A & N ISLANDS,2004,Educational Standard - Below Class X,48,1,49,142,1,143,0,0,0,0,0,0,190,2,192
A & N ISLANDS,2004,Educational Standard - Class X and above but below graduate,5,0,5,16,0,16,0,0,0,0,0,0,21,0,21
A & N ISLANDS,2004,Educational Standard - Graduate,1,1,2,1,0,1,0,0,0,0,0,0,2,1,3
A & N ISLANDS,2004,Educational Standard - Post-Graduate,0,0,0,0,0,0,0,0,0,0,0,0,0,0,0
A & N ISLANDS,2004,Educational Standard - Holding technical degree/diploma etc,0,0,0,0,0,0,0,0,0,0,0,0,0,0,0
A & N ISLANDS,2005,Educational Standard,65,1,66,155,3,158,0,0,0,0,0,0,220,4,224
A & N ISLANDS,2005,Educational Standard - Illiterate,4,0,4,7,1,8,0,0,0,0,0,0,11,1,12
A & N ISLANDS,2005,Educational Standard - Below Class X,46,0,46,137,2,139,0,0,0,0,0,0,183,2,185
A & N ISLANDS,2005,Educational Standard - Class X and above but below graduate,14,0,14,10,0,10,0,0,0,0,0,0,24,0,24
A & N ISLANDS,2005,Educational Standard - Graduate,1,1,2,1,0,1,0,0,0,0,0,0,2,1,3
A & N ISLANDS,2005,Educational Standard - Post-Graduate,0,0,0,0,0,0,0,0,0,0,0,0,0,0,0
A & N ISLANDS,2005,Educational Standard - Holding technical degree/diploma etc,0,0,0,0,0,0,0,0,0,0,0,0,0,0,0
A & N ISLANDS,2006,Educational Standard,80,1,81,264,1,265,0,0,0,0,0,0,344,2,346
A & N ISLANDS,2006,Educational Standard - Illiterate,4,0,4,7,1,8,0,0,0,0,0,0,11,1,12
A & N ISLANDS,2006,Educational Standard - Below Class X,61,0,61,246,0,246,0,0,0,0,0,0,307,0,307
A & N ISLANDS,2006,Educational Standard - Class X and above but below graduate,14,0,14,10,0,10,0,0,0,0,0,0,24,0,24
A & N ISLANDS,2006,Educational Standard - Graduate,1,1,2,1,0,1,0,0,0,0,0,0,2,1,3
A & N ISLANDS,2006,Educational Standard - Post-Graduate,0,0,0,0,0,0,0,0,0,0,0,0,0,0,0
A & N ISLANDS,2006,Educational Standard - Holding technical degree/diploma etc,0,0,0,0,0,0,0,0,0,0,0,0,0,0,0
A & N ISLANDS,2007,Educational Standard,87,1,88,324,1,325,0,0,0,0,0,0,411,2,413
A & N ISLANDS,2007,Educational Standard - Illiterate,1,0,1,2,0,2,0,0,0,0,0,0,3,0,3
A & N ISLANDS,2007,Educational Standard - Below Class X,82,0,82,314,1,315,0,0,0,0,0,0,396,1,397
A & N ISLANDS,2007,Educational Standard - Class X and above but below graduate,3,1,4,7,0,7,0,0,0,0,0,0,10,1,11
A & N ISLANDS,2007,Educational Standard - Graduate,1,0,1,1,0,1,0,0,0,0,0,0,2,0,2
A & N ISLANDS,2007,Educational Standard - Post-Graduate,0,0,0,0,0,0,0,0,0,0,0,0,0,0,0
A & N ISLANDS,2007,Educational Standard - Holding technical degree/diploma etc,0,0,0,0,0,0,0,0,0,0,0,0,0,0,0
A & N ISLANDS,2008,Educational Standard,68,0,68,153,0,153,0,0,0,0,0,0,221,0,221
A & N ISLANDS,2008,Educational Standard - Illiterate,0,0,0,2,0,2,0,0,0,0,0,0,2,0,2
A & N ISLANDS,2008,Educational Standard - Below Class X,64,0,64,137,0,137,0,0,0,0,0,0,201,0,201
A & N ISLANDS,2008,Educational Standard - Class X and above but below graduate,3,0,3,12,0,12,0,0,0,0,0,0,15,0,15
A & N ISLANDS,2008,Educational Standard - Graduate,1,0,1,2,0,2,0,0,0,0,0,0,3,0,3
A & N ISLANDS,2008,Educational Standard - Post-Graduate,0,0,0,0,0,0,0,0,0,0,0,0,0,0,0
A & N ISLANDS,2008,Educational Standard - Holding technical degree/diploma etc,0,0,0,0,0,0,0,0,0,0,0,0,0,0,0
A & N ISLANDS,2009,Educational Standard,48,0,48,180,0,180,0,0,0,0,0,0,228,0,228
A & N ISLANDS,2009,Educational Standard - Illiterate,0,0,0,3,0,3,0,0,0,0,0,0,3,0,3
A & N ISLANDS,2009,Educational Standard - Below Class X,43,0,43,153,0,153,0,0,0,0,0,0,196,0,196
A & N ISLANDS,2009,Educational Standard - Class X and above but below graduate,4,0,4,22,0,22,0,0,0,0,0,0,26,0,26
A & N ISLANDS,2009,Educational Standard - Graduate,1,0,1,2,0,2,0,0,0,0,0,0,3,0,3
A & N ISLANDS,2009,Educational Standard - Post-Graduate,0,0,0,0,0,0,0,0,0,0,0,0,0,0,0
A & N ISLANDS,2009,Educational Standard - Holding technical degree/diploma etc,0,0,0,0,0,0,0,0,0,0,0,0,0,0,0
A & N ISLANDS,2010,Educational Standard,129,0,129,557,2,559,0,0,0,0,0,0,686,2,688
A & N ISLANDS,2010,Educational Standard - Illiterate,4,0,4,7,0,7,0,0,0,0,0,0,11,0,11
A & N ISLANDS,2010,Educational Standard - Below Class X,62,0,62,504,2,506,0,0,0,0,0,0,566,2,568
A & N ISLANDS,2010,Educational Standard - Class X and above but below graduate,49,0,49,29,0,29,0,0,0,0,0,0,78,0,78
A & N ISLANDS,2010,Educational Standard - Graduate,5,0,5,2,0,2,0,0,0,0,0,0,7,0,7
A & N ISLANDS,2010,Educational Standard - Post-Graduate,0,0,0,3,0,3,0,0,0,0,0,0,3,0,3
A & N ISLANDS,2010,Educational Standard - Holding technical degree/diploma etc,9,0,9,12,0,12,0,0,0,0,0,0,21,0,21
A & N ISLANDS,2011,Educational Standard,415,0,415,697,7,704,0,0,0,0,0,0,1112,7,1119
A & N ISLANDS,2011,Educational Standard - Illiterate,35,0,35,70,0,70,0,0,0,0,0,0,105,0,105
A & N ISLANDS,2011,Educational Standard - Below Class X,213,0,213,490,2,492,0,0,0,0,0,0,703,2,705
A & N ISLANDS,2011,Educational Standard - Class X and above but below graduate,120,0,120,60,5,65,0,0,0,0,0,0,180,5,185
A & N ISLANDS,2011,Educational Standard - Graduate,35,0,35,55,0,55,0,0,0,0,0,0,90,0,90
A & N ISLANDS,2011,Educational Standard - Post-Graduate,7,0,7,13,0,13,0,0,0,0,0,0,20,0,20
A & N ISLANDS,2011,Educational Standard - Holding technical degree/diploma etc,5,0,5,9,0,9,0,0,0,0,0,0,14,0,14
A & N ISLANDS,2012,Educational Standard,760,0,760,357,9,366,0,0,0,0,0,0,1117,9,1126
A & N ISLANDS,2012,Educational Standard - Illiterate,89,0,89,47,0,47,0,0,0,0,0,0,136,0,136
A & N ISLANDS,2012,Educational Standard - Below Class X,419,0,419,215,5,220,0,0,0,0,0,0,634,5,639
A & N ISLANDS,2012,Educational Standard - Class X and above but below graduate,231,0,231,85,4,89,0,0,0,0,0,0,316,4,320
A & N ISLANDS,2012,Educational Standard - Graduate,11,0,11,3,0,3,0,0,0,0,0,0,14,0,14
A & N ISLANDS,2012,Educational Standard - Post-Graduate,3,0,3,2,0,2,0,0,0,0,0,0,5,0,5
A & N ISLANDS,2012,Educational Standard - Holding technical degree/diploma etc,7,0,7,5,0,5,0,0,0,0,0,0,12,0,12
CHANDIGARH,2001,Educational Standard,96,6,102,306,18,324,0,0,0,0,0,0,402,24,426
CHANDIGARH,2001,Educational Standard - Illiterate,18,2,20,69,6,75,0,0,0,0,0,0,87,8,95
CHANDIGARH,2001,Educational Standard - Below Class X,35,1,36,84,5,89,0,0,0,0,0,0,119,6,125
CHANDIGARH,2001,Educational Standard - Class X and above but below graduate,39,3,42,116,6,122,0,0,0,0,0,0,155,9,164
CHANDIGARH,2001,Educational Standard - Graduate,4,0,4,37,1,38,0,0,0,0,0,0,41,1,42
CHANDIGARH,2001,Educational Standard - Post-Graduate,0,0,0,0,0,0,0,0,0,0,0,0,0,0,0
CHANDIGARH,2001,Educational Standard - Holding technical degree/diploma etc,0,0,0,0,0,0,0,0,0,0,0,0,0,0,0
CHANDIGARH,2002,Educational Standard,104,7,111,329,16,345,0,0,0,0,0,0,433,23,456
CHANDIGARH,2002,Educational Standard - Illiterate,29,3,32,67,6,73,0,0,0,0,0,0,96,9,105
CHANDIGARH,2002,Educational Standard - Below Class X,22,1,23,80,3,83,0,0,0,0,0,0,102,4,106
CHANDIGARH,2002,Educational Standard - Class X and above but below graduate,34,2,36,102,3,105,0,0,0,0,0,0,136,5,141
CHANDIGARH,2002,Educational Standard - Graduate,18,1,19,65,4,69,0,0,0,0,0,0,83,5,88
CHANDIGARH,2002,Educational Standard - Post-Graduate,1,0,1,15,0,15,0,0,0,0,0,0,16,0,16
CHANDIGARH,2002,Educational Standard - Holding technical degree/diploma etc,0,0,0,0,0,0,0,0,0,0,0,0,0,0,0
CHANDIGARH,2003,Educational Standard,135,9,144,363,18,381,0,0,0,0,0,0,498,27,525
CHANDIGARH,2003,Educational Standard - Illiterate,40,2,42,85,3,88,0,0,0,0,0,0,125,5,130
CHANDIGARH,2003,Educational Standard - Below Class X,34,3,37,121,5,126,0,0,0,0,0,0,155,8,163
CHANDIGARH,2003,Educational Standard - Class X and above but below graduate,42,3,45,110,6,116,0,0,0,0,0,0,152,9,161
CHANDIGARH,2003,Educational Standard - Graduate,12,1,13,36,3,39,0,0,0,0,0,0,48,4,52
CHANDIGARH,2003,Educational Standard - Post-Graduate,3,0,3,5,1,6,0,0,0,0,0,0,8,1,9
CHANDIGARH,2003,Educational Standard - Holding technical degree/diploma etc,4,0,4,6,0,6,0,0,0,0,0,0,10,0,10
CHANDIGARH,2004,Educational Standard,113,7,120,405,24,429,0,0,0,0,0,0,518,31,549
CHANDIGARH,2004,Educational Standard - Illiterate,36,3,39,112,4,116,0,0,0,0,0,0,148,7,155
CHANDIGARH,2004,Educational Standard - Below Class X,29,2,31,128,8,136,0,0,0,0,0,0,157,10,167
CHANDIGARH,2004,Educational Standard - Class X and above but below graduate,39,2,41,142,8,150,0,0,0,0,0,0,181,10,191
CHANDIGARH,2004,Educational Standard - Graduate,6,0,6,12,2,14,0,0,0,0,0,0,18,2,20
CHANDIGARH,2004,Educational Standard - Post-Graduate,1,0,1,8,1,9,0,0,0,0,0,0,9,1,10
CHANDIGARH,2004,Educational Standard - Holding technical degree/diploma etc,2,0,2,3,1,4,0,0,0,0,0,0,5,1,6
CHANDIGARH,2005,Educational Standard,78,6,84,351,20,371,0,0,0,0,0,0,429,26,455
CHANDIGARH,2005,Educational Standard - Illiterate,32,3,35,115,8,123,0,0,0,0,0,0,147,11,158
CHANDIGARH,2005,Educational Standard - Below Class X,18,2,20,96,4,100,0,0,0,0,0,0,114,6,120
CHANDIGARH,2005,Educational Standard - Class X and above but below graduate,14,1,15,88,4,92,0,0,0,0,0,0,102,5,107
CHANDIGARH,2005,Educational Standard - Graduate,9,0,9,32,3,35,0,0,0,0,0,0,41,3,44
CHANDIGARH,2005,Educational Standard - Post-Graduate,4,0,4,12,0,12,0,0,0,0,0,0,16,0,16
CHANDIGARH,2005,Educational Standard - Holding technical degree/diploma etc,1,0,1,8,1,9,0,0,0,0,0,0,9,1,10
CHANDIGARH,2006,Educational Standard,100,7,107,312,19,331,0,0,0,0,0,0,412,26,438
CHANDIGARH,2006,Educational Standard - Illiterate,40,3,43,94,4,98,0,0,0,0,0,0,134,7,141
CHANDIGARH,2006,Educational Standard - Below Class X,25,1,26,111,5,116,0,0,0,0,0,0,136,6,142
CHANDIGARH,2006,Educational Standard - Class X and above but below graduate,22,1,23,74,6,80,0,0,0,0,0,0,96,7,103
CHANDIGARH,2006,Educational Standard - Graduate,12,2,14,24,3,27,0,0,0,0,0,0,36,5,41
CHANDIGARH,2006,Educational Standard - Post-Graduate,1,0,1,6,0,6,0,0,0,0,0,0,7,0,7
CHANDIGARH,2006,Educational Standard - Holding technical degree/diploma etc,0,0,0,3,1,4,0,0,0,0,0,0,3,1,4
CHANDIGARH,2007,Educational Standard,141,5,146,342,13,355,0,0,0,0,0,0,483,18,501
CHANDIGARH,2007,Educational Standard - Illiterate,48,2,50,107,4,111,0,0,0,0,0,0,155,6,161
CHANDIGARH,2007,Educational Standard - Below Class X,37,1,38,116,3,119,0,0,0,0,0,0,153,4,157
CHANDIGARH,2007,Educational Standard - Class X and above but below graduate,38,1,39,102,3,105,0,0,0,0,0,0,140,4,144
CHANDIGARH,2007,Educational Standard - Graduate,14,1,15,11,2,13,0,0,0,0,0,0,25,3,28
CHANDIGARH,2007,Educational Standard - Post-Graduate,1,0,1,2,0,2,0,0,0,0,0,0,3,0,3
CHANDIGARH,2007,Educational Standard - Holding technical degree/diploma etc,3,0,3,4,1,5,0,0,0,0,0,0,7,1,8
CHANDIGARH,2008,Educational Standard,183,5,188,326,12,338,0,0,0,0,0,0,509,17,526
CHANDIGARH,2008,Educational Standard - Illiterate,32,2,34,64,3,67,0,0,0,0,0,0,96,5,101
CHANDIGARH,2008,Educational Standard - Below Class X,48,0,48,96,2,98,0,0,0,0,0,0,144,2,146
CHANDIGARH,2008,Educational Standard - Class X and above but below graduate,92,3,95,130,3,133,0,0,0,0,0,0,222,6,228
CHANDIGARH,2008,Educational Standard - Graduate,9,0,9,20,2,22,0,0,0,0,0,0,29,2,31
CHANDIGARH,2008,Educational Standard - Post-Graduate,1,0,1,10,2,12,0,0,0,0,0,0,11,2,13
CHANDIGARH,2008,Educational Standard - Holding technical degree/diploma etc,1,0,1,6,0,6,0,0,0,0,0,0,7,0,7
CHANDIGARH,2009,Educational Standard,235,9,244,379,20,399,0,0,0,0,0,0,614,29,643
CHANDIGARH,2009,Educational Standard - Illiterate,52,2,54,92,5,97,0,0,0,0,0,0,144,7,151
CHANDIGARH,2009,Educational Standard - Below Class X,64,2,66,106,7,113,0,0,0,0,0,0,170,9,179
CHANDIGARH,2009,Educational Standard - Class X and above but below graduate,98,3,101,140,6,146,0,0,0,0,0,0,238,9,247
CHANDIGARH,2009,Educational Standard - Graduate,12,0,12,18,2,20,0,0,0,0,0,0,30,2,32
CHANDIGARH,2009,Educational Standard - Post-Graduate,4,0,4,13,0,13,0,0,0,0,0,0,17,0,17
CHANDIGARH,2009,Educational Standard - Holding technical degree/diploma etc,5,2,7,10,0,10,0,0,0,0,0,0,15,2,17
CHANDIGARH,2010,Educational Standard,211,10,221,400,19,419,0,0,0,0,0,0,611,29,640
CHANDIGARH,2010,Educational Standard - Illiterate,46,3,49,87,4,91,0,0,0,0,0,0,133,7,140
CHANDIGARH,2010,Educational Standard - Below Class X,57,1,58,105,5,110,0,0,0,0,0,0,162,6,168
CHANDIGARH,2010,Educational Standard - Class X and above but below graduate,92,4,96,155,7,162,0,0,0,0,0,0,247,11,258
CHANDIGARH,2010,Educational Standard - Graduate,10,1,11,28,3,31,0,0,0,0,0,0,38,4,42
CHANDIGARH,2010,Educational Standard - Post-Graduate,2,0,2,21,0,21,0,0,0,0,0,0,23,0,23
CHANDIGARH,2010,Educational Standard - Holding technical degree/diploma etc,4,1,5,4,0,4,0,0,0,0,0,0,8,1,9
CHANDIGARH,2011,Educational Standard,236,6,242,368,16,384,0,0,0,0,0,0,604,22,626
CHANDIGARH,2011,Educational Standard - Illiterate,43,2,45,76,3,79,0,0,0,0,0,0,119,5,124
CHANDIGARH,2011,Educational Standard - Below Class X,84,1,85,109,7,116,0,0,0,0,0,0,193,8,201
CHANDIGARH,2011,Educational Standard - Class X and above but below graduate,96,2,98,145,3,148,0,0,0,0,0,0,241,5,246
CHANDIGARH,2011,Educational Standard - Graduate,7,1,8,17,2,19,0,0,0,0,0,0,24,3,27
CHANDIGARH,2011,Educational Standard - Post-Graduate,3,0,3,12,0,12,0,0,0,0,0,0,15,0,15
CHANDIGARH,2011,Educational Standard - Holding technical degree/diploma etc,3,0,3,9,1,10,0,0,0,0,0,0,12,1,13
CHANDIGARH,2012,Educational Standard,246,15,261,447,26,473,0,0,0,0,0,0,693,41,734
CHANDIGARH,2012,Educational Standard - Illiterate,74,6,80,112,4,116,0,0,0,0,0,0,186,10,196
CHANDIGARH,2012,Educational Standard - Below Class X,65,4,69,156,8,164,0,0,0,0,0,0,221,12,233
CHANDIGARH,2012,Educational Standard - Class X and above but below graduate,96,2,98,127,11,138,0,0,0,0,0,0,223,13,236
CHANDIGARH,2012,Educational Standard - Graduate,10,1,11,37,2,39,0,0,0,0,0,0,47,3,50
CHANDIGARH,2012,Educational Standard - Post-Graduate,1,1,2,10,1,11,0,0,0,0,0,0,11,2,13
CHANDIGARH,2012,Educational Standard - Holding technical degree/diploma etc,0,1,1,5,0,5,0,0,0,0,0,0,5,1,6
D & N HAVELI,2001,Educational Standard,8,0,8,153,5,158,0,0,0,0,0,0,161,5,166
D & N HAVELI,2001,Educational Standard - Illiterate,6,0,6,103,3,106,0,0,0,0,0,0,109,3,112
D & N HAVELI,2001,Educational Standard - Below Class X,2,0,2,33,2,35,0,0,0,0,0,0,35,2,37
D & N HAVELI,2001,Educational Standard - Class X and above but below graduate,0,0,0,17,0,17,0,0,0,0,0,0,17,0,17
D & N HAVELI,2001,Educational Standard - Graduate,0,0,0,0,0,0,0,0,0,0,0,0,0,0,0
D & N HAVELI,2001,Educational Standard - Post-Graduate,0,0,0,0,0,0,0,0,0,0,0,0,0,0,0
D & N HAVELI,2001,Educational Standard - Holding technical degree/diploma etc,0,0,0,0,0,0,0,0,0,0,0,0,0,0,0
D & N HAVELI,2002,Educational Standard,4,1,5,154,1,155,0,0,0,0,0,0,158,2,160
D & N HAVELI,2002,Educational Standard - Illiterate,2,1,3,100,1,101,0,0,0,0,0,0,102,2,104
D & N HAVELI,2002,Educational Standard - Below Class X,2,0,2,40,0,40,0,0,0,0,0,0,42,0,42
D & N HAVELI,2002,Educational Standard - Class X and above but below graduate,0,0,0,14,0,14,0,0,0,0,0,0,14,0,14
D & N HAVELI,2002,Educational Standard - Graduate,0,0,0,0,0,0,0,0,0,0,0,0,0,0,0
D & N HAVELI,2002,Educational Standard - Post-Graduate,0,0,0,0,0,0,0,0,0,0,0,0,0,0,0
D & N HAVELI,2002,Educational Standard - Holding technical degree/diploma etc,0,0,0,0,0,0,0,0,0,0,0,0,0,0,0
D & N HAVELI,2003,Educational Standard,0,0,0,172,0,172,0,0,0,0,0,0,172,0,172
D & N HAVELI,2003,Educational Standard - Illiterate,0,0,0,42,0,42,0,0,0,0,0,0,42,0,42
D & N HAVELI,2003,Educational Standard - Below Class X,0,0,0,90,0,90,0,0,0,0,0,0,90,0,90
D & N HAVELI,2003,Educational Standard - Class X and above but below graduate,0,0,0,35,0,35,0,0,0,0,0,0,35,0,35
D & N HAVELI,2003,Educational Standard - Graduate,0,0,0,5,0,5,0,0,0,0,0,0,5,0,5
D & N HAVELI,2003,Educational Standard - Post-Graduate,0,0,0,0,0,0,0,0,0,0,0,0,0,0,0
D & N HAVELI,2003,Educational Standard - Holding technical degree/diploma etc,0,0,0,0,0,0,0,0,0,0,0,0,0,0,0
D & N HAVELI,2004,Educational Standard,0,0,0,33,0,33,0,0,0,0,0,0,33,0,33
D & N HAVELI,2004,Educational Standard - Illiterate,0,0,0,0,0,0,0,0,0,0,0,0,0,0,0
D & N HAVELI,2004,Educational Standard - Below Class X,0,0,0,25,0,25,0,0,0,0,0,0,25,0,25
D & N HAVELI,2004,Educational Standard - Class X and above but below graduate,0,0,0,5,0,5,0,0,0,0,0,0,5,0,5
D & N HAVELI,2004,Educational Standard - Graduate,0,0,0,3,0,3,0,0,0,0,0,0,3,0,3
D & N HAVELI,2004,Educational Standard - Post-Graduate,0,0,0,0,0,0,0,0,0,0,0,0,0,0,0
D & N HAVELI,2004,Educational Standard - Holding technical degree/diploma etc,0,0,0,0,0,0,0,0,0,0,0,0,0,0,0
D & N HAVELI,2005,Educational Standard,0,0,0,29,0,29,0,0,0,0,0,0,29,0,29
D & N HAVELI,2005,Educational Standard - Illiterate,0,0,0,0,0,0,0,0,0,0,0,0,0,0,0
D & N HAVELI,2005,Educational Standard - Below Class X,0,0,0,24,0,24,0,0,0,0,0,0,24,0,24
D & N HAVELI,2005,Educational Standard - Class X and above but below graduate,0,0,0,3,0,3,0,0,0,0,0,0,3,0,3
D & N HAVELI,2005,Educational Standard - Graduate,0,0,0,2,0,2,0,0,0,0,0,0,2,0,2
D & N HAVELI,2005,Educational Standard - Post-Graduate,0,0,0,0,0,0,0,0,0,0,0,0,0,0,0
D & N HAVELI,2005,Educational Standard - Holding technical degree/diploma etc,0,0,0,0,0,0,0,0,0,0,0,0,0,0,0
D & N HAVELI,2006,Educational Standard,0,0,0,33,0,33,0,0,0,0,0,0,33,0,33
D & N HAVELI,2006,Educational Standard - Illiterate,0,0,0,3,0,3,0,0,0,0,0,0,3,0,3
D & N HAVELI,2006,Educational Standard - Below Class X,0,0,0,28,0,28,0,0,0,0,0,0,28,0,28
D & N HAVELI,2006,Educational Standard - Class X and above but below graduate,0,0,0,1,0,1,0,0,0,0,0,0,1,0,1
D & N HAVELI,2006,Educational Standard - Graduate,0,0,0,1,0,1,0,0,0,0,0,0,1,0,1
D & N HAVELI,2006,Educational Standard - Post-Graduate,0,0,0,0,0,0,0,0,0,0,0,0,0,0,0
D & N HAVELI,2006,Educational Standard - Holding technical degree/diploma etc,0,0,0,0,0,0,0,0,0,0,0,0,0,0,0
D & N HAVELI,2007,Educational Standard,0,0,0,28,0,28,0,0,0,0,0,0,28,0,28
D & N HAVELI,2007,Educational Standard - Illiterate,0,0,0,6,0,6,0,0,0,0,0,0,6,0,6
D & N HAVELI,2007,Educational Standard - Below Class X,0,0,0,11,0,11,0,0,0,0,0,0,11,0,11
D & N HAVELI,2007,Educational Standard - Class X and above but below graduate,0,0,0,10,0,10,0,0,0,0,0,0,10,0,10
D & N HAVELI,2007,Educational Standard - Graduate,0,0,0,1,0,1,0,0,0,0,0,0,1,0,1
D & N HAVELI,2007,Educational Standard - Post-Graduate,0,0,0,0,0,0,0,0,0,0,0,0,0,0,0
D & N HAVELI,2007,Educational Standard - Holding technical degree/diploma etc,0,0,0,0,0,0,0,0,0,0,0,0,0,0,0
D & N HAVELI,2008,Educational Standard,11,0,11,32,3,35,0,0,0,0,0,0,43,3,46
D & N HAVELI,2008,Educational Standard - Illiterate,3,0,3,11,2,13,0,0,0,0,0,0,14,2,16
D & N HAVELI,2008,Educational Standard - Below Class X,4,0,4,14,1,15,0,0,0,0,0,0,18,1,19
D & N HAVELI,2008,Educational Standard - Class X and above but below graduate,2,0,2,6,0,6,0,0,0,0,0,0,8,0,8
D & N HAVELI,2008,Educational Standard - Graduate,2,0,2,1,0,1,0,0,0,0,0,0,3,0,3
D & N HAVELI,2008,Educational Standard - Post-Graduate,0,0,0,0,0,0,0,0,0,0,0,0,0,0,0
D & N HAVELI,2008,Educational Standard - Holding technical degree/diploma etc,0,0,0,0,0,0,0,0,0,0,0,0,0,0,0
D & N HAVELI,2009,Educational Standard,2,0,2,52,2,54,0,0,0,0,0,0,54,2,56
D & N HAVELI,2009,Educational Standard - Illiterate,1,0,1,23,1,24,0,0,0,0,0,0,24,1,25
D & N HAVELI,2009,Educational Standard - Below Class X,0,0,0,27,1,28,0,0,0,0,0,0,27,1,28
D & N HAVELI,2009,Educational Standard - Class X and above but below graduate,1,0,1,1,0,1,0,0,0,0,0,0,2,0,2
D & N HAVELI,2009,Educational Standard - Graduate,0,0,0,1,0,1,0,0,0,0,0,0,1,0,1
D & N HAVELI,2009,Educational Standard - Post-Graduate,0,0,0,0,0,0,0,0,0,0,0,0,0,0,0
D & N HAVELI,2009,Educational Standard - Holding technical degree/diploma etc,0,0,0,0,0,0,0,0,0,0,0,0,0,0,0
D & N HAVELI,2010,Educational Standard,0,0,0,42,0,42,0,0,0,0,0,0,42,0,42
D & N HAVELI,2010,Educational Standard - Illiterate,0,0,0,8,0,8,0,0,0,0,0,0,8,0,8
D & N HAVELI,2010,Educational Standard - Below Class X,0,0,0,22,0,22,0,0,0,0,0,0,22,0,22
D & N HAVELI,2010,Educational Standard - Class X and above but below graduate,0,0,0,11,0,11,0,0,0,0,0,0,11,0,11
D & N HAVELI,2010,Educational Standard - Graduate,0,0,0,1,0,1,0,0,0,0,0,0,1,0,1
D & N HAVELI,2010,Educational Standard - Post-Graduate,0,0,0,0,0,0,0,0,0,0,0,0,0,0,0
D & N HAVELI,2010,Educational Standard - Holding technical degree/diploma etc,0,0,0,0,0,0,0,0,0,0,0,0,0,0,0
D & N HAVELI,2011,Educational Standard,0,0,0,23,2,25,0,0,0,0,0,0,23,2,25
D & N HAVELI,2011,Educational Standard - Illiterate,0,0,0,4,1,5,0,0,0,0,0,0,4,1,5
D & N HAVELI,2011,Educational Standard - Below Class X,0,0,0,12,1,13,0,0,0,0,0,0,12,1,13
D & N HAVELI,2011,Educational Standard - Class X and above but below graduate,0,0,0,6,0,6,0,0,0,0,0,0,6,0,6
D & N HAVELI,2011,Educational Standard - Graduate,0,0,0,1,0,1,0,0,0,0,0,0,1,0,1
D & N HAVELI,2011,Educational Standard - Post-Graduate,0,0,0,0,0,0,0,0,0,0,0,0,0,0,0
D & N HAVELI,2011,Educational Standard - Holding technical degree/diploma etc,0,0,0,0,0,0,0,0,0,0,0,0,0,0,0
D & N HAVELI,2012,Educational Standard,0,0,0,35,2,37,0,0,0,0,0,0,35,2,37
D & N HAVELI,2012,Educational Standard - Illiterate,0,0,0,8,0,8,0,0,0,0,0,0,8,0,8
D & N HAVELI,2012,Educational Standard - Below Class X,0,0,0,10,1,11,0,0,0,0,0,0,10,1,11
D & N HAVELI,2012,Educational Standard - Class X and above but below graduate,0,0,0,8,0,8,0,0,0,0,0,0,8,0,8
D & N HAVELI,2012,Educational Standard - Graduate,0,0,0,8,1,9,0,0,0,0,0,0,8,1,9
D & N HAVELI,2012,Educational Standard - Post-Graduate,0,0,0,0,0,0,0,0,0,0,0,0,0,0,0
D & N HAVELI,2012,Educational Standard - Holding technical degree/diploma etc,0,0,0,1,0,1,0,0,0,0,0,0,1,0,1
DAMAN & DIU,2001,Educational Standard,23,0,23,17,1,18,0,0,0,0,0,0,40,1,41
DAMAN & DIU,2001,Educational Standard - Illiterate,2,0,2,4,0,4,0,0,0,0,0,0,6,0,6
DAMAN & DIU,2001,Educational Standard - Below Class X,16,0,16,13,0,13,0,0,0,0,0,0,29,0,29
DAMAN & DIU,2001,Educational Standard - Class X and above but below graduate,3,0,3,0,0,0,0,0,0,0,0,0,3,0,3
DAMAN & DIU,2001,Educational Standard - Graduate,2,0,2,0,1,1,0,0,0,0,0,0,2,1,3
DAMAN & DIU,2001,Educational Standard - Post-Graduate,0,0,0,0,0,0,0,0,0,0,0,0,0,0,0
DAMAN & DIU,2001,Educational Standard - Holding technical degree/diploma etc,0,0,0,0,0,0,0,0,0,0,0,0,0,0,0
DAMAN & DIU,2002,Educational Standard,13,0,13,20,0,20,0,0,0,0,0,0,33,0,33
DAMAN & DIU,2002,Educational Standard - Illiterate,0,0,0,6,0,6,0,0,0,0,0,0,6,0,6
DAMAN & DIU,2002,Educational Standard - Below Class X,5,0,5,9,0,9,0,0,0,0,0,0,14,0,14
DAMAN & DIU,2002,Educational Standard - Class X and above but below graduate,6,0,6,5,0,5,0,0,0,0,0,0,11,0,11
DAMAN & DIU,2002,Educational Standard - Graduate,1,0,1,0,0,0,0,0,0,0,0,0,1,0,1
DAMAN & DIU,2002,Educational Standard - Post-Graduate,1,0,1,0,0,0,0,0,0,0,0,0,1,0,1
DAMAN & DIU,2002,Educational Standard - Holding technical degree/diploma etc,0,0,0,0,0,0,0,0,0,0,0,0,0,0,0
DAMAN & DIU,2003,Educational Standard,13,0,13,20,0,20,0,0,0,0,0,0,33,0,33
DAMAN & DIU,2003,Educational Standard - Illiterate,0,0,0,4,0,4,0,0,0,0,0,0,4,0,4
DAMAN & DIU,2003,Educational Standard - Below Class X,7,0,7,13,0,13,0,0,0,0,0,0,20,0,20
DAMAN & DIU,2003,Educational Standard - Class X and above but below graduate,5,0,5,3,0,3,0,0,0,0,0,0,8,0,8
DAMAN & DIU,2003,Educational Standard - Graduate,1,0,1,0,0,0,0,0,0,0,0,0,1,0,1
DAMAN & DIU,2003,Educational Standard - Post-Graduate,0,0,0,0,0,0,0,0,0,0,0,0,0,0,0
DAMAN & DIU,2003,Educational Standard - Holding technical degree/diploma etc,0,0,0,0,0,0,0,0,0,0,0,0,0,0,0
DAMAN & DIU,2004,Educational Standard,8,0,8,18,1,19,0,0,0,0,0,0,26,1,27
DAMAN & DIU,2004,Educational Standard - Illiterate,0,0,0,6,0,6,0,0,0,0,0,0,6,0,6
DAMAN & DIU,2004,Educational Standard - Below Class X,7,0,7,10,1,11,0,0,0,0,0,0,17,1,18
DAMAN & DIU,2004,Educational Standard - Class X and above but below graduate,0,0,0,2,0,2,0,0,0,0,0,0,2,0,2
DAMAN & DIU,2004,Educational Standard - Graduate,1,0,1,0,0,0,0,0,0,0,0,0,1,0,1
DAMAN & DIU,2004,Educational Standard - Post-Graduate,0,0,0,0,0,0,0,0,0,0,0,0,0,0,0
DAMAN & DIU,2004,Educational Standard - Holding technical degree/diploma etc,0,0,0,0,0,0,0,0,0,0,0,0,0,0,0
DAMAN & DIU,2005,Educational Standard,11,0,11,23,1,24,0,0,0,0,0,0,34,1,35
DAMAN & DIU,2005,Educational Standard - Illiterate,0,0,0,2,1,3,0,0,0,0,0,0,2,1,3
DAMAN & DIU,2005,Educational Standard - Below Class X,10,0,10,21,0,21,0,0,0,0,0,0,31,0,31
DAMAN & DIU,2005,Educational Standard - Class X and above but below graduate,0,0,0,0,0,0,0,0,0,0,0,0,0,0,0
DAMAN & DIU,2005,Educational Standard - Graduate,1,0,1,0,0,0,0,0,0,0,0,0,1,0,1
DAMAN & DIU,2005,Educational Standard - Post-Graduate,0,0,0,0,0,0,0,0,0,0,0,0,0,0,0
DAMAN & DIU,2005,Educational Standard - Holding technical degree/diploma etc,0,0,0,0,0,0,0,0,0,0,0,0,0,0,0
DAMAN & DIU,2006,Educational Standard,12,0,12,41,1,42,0,0,0,0,0,0,53,1,54
DAMAN & DIU,2006,Educational Standard - Illiterate,2,0,2,0,1,1,0,0,0,0,0,0,2,1,3
DAMAN & DIU,2006,Educational Standard - Below Class X,8,0,8,41,0,41,0,0,0,0,0,0,49,0,49
DAMAN & DIU,2006,Educational Standard - Class X and above but below graduate,0,0,0,0,0,0,0,0,0,0,0,0,0,0,0
DAMAN & DIU,2006,Educational Standard - Graduate,0,0,0,0,0,0,0,0,0,0,0,0,0,0,0
DAMAN & DIU,2006,Educational Standard - Post-Graduate,2,0,2,0,0,0,0,0,0,0,0,0,2,0,2
DAMAN & DIU,2006,Educational Standard - Holding technical degree/diploma etc,0,0,0,0,0,0,0,0,0,0,0,0,0,0,0
DAMAN & DIU,2007,Educational Standard,8,2,10,52,4,56,0,0,0,0,0,0,60,6,66
DAMAN & DIU,2007,Educational Standard - Illiterate,6,2,8,28,4,32,0,0,0,0,0,0,34,6,40
DAMAN & DIU,2007,Educational Standard - Below Class X,2,0,2,24,0,24,0,0,0,0,0,0,26,0,26
DAMAN & DIU,2007,Educational Standard - Class X and above but below graduate,0,0,0,0,0,0,0,0,0,0,0,0,0,0,0
DAMAN & DIU,2007,Educational Standard - Graduate,0,0,0,0,0,0,0,0,0,0,0,0,0,0,0
DAMAN & DIU,2007,Educational Standard - Post-Graduate,0,0,0,0,0,0,0,0,0,0,0,0,0,0,0
DAMAN & DIU,2007,Educational Standard - Holding technical degree/diploma etc,0,0,0,0,0,0,0,0,0,0,0,0,0,0,0
DAMAN & DIU,2008,Educational Standard,14,2,16,26,1,27,0,0,0,0,0,0,40,3,43
DAMAN & DIU,2008,Educational Standard - Illiterate,10,2,12,16,1,17,0,0,0,0,0,0,26,3,29
DAMAN & DIU,2008,Educational Standard - Below Class X,4,0,4,10,0,10,0,0,0,0,0,0,14,0,14
DAMAN & DIU,2008,Educational Standard - Class X and above but below graduate,0,0,0,0,0,0,0,0,0,0,0,0,0,0,0
DAMAN & DIU,2008,Educational Standard - Graduate,0,0,0,0,0,0,0,0,0,0,0,0,0,0,0
DAMAN & DIU,2008,Educational Standard - Post-Graduate,0,0,0,0,0,0,0,0,0,0,0,0,0,0,0
DAMAN & DIU,2008,Educational Standard - Holding technical degree/diploma etc,0,0,0,0,0,0,0,0,0,0,0,0,0,0,0
DAMAN & DIU,2009,Educational Standard,15,1,16,24,0,24,0,0,0,0,0,0,39,1,40
DAMAN & DIU,2009,Educational Standard - Illiterate,2,1,3,0,0,0,0,0,0,0,0,0,2,1,3
DAMAN & DIU,2009,Educational Standard - Below Class X,13,0,13,24,0,24,0,0,0,0,0,0,37,0,37
DAMAN & DIU,2009,Educational Standard - Class X and above but below graduate,0,0,0,0,0,0,0,0,0,0,0,0,0,0,0
DAMAN & DIU,2009,Educational Standard - Graduate,0,0,0,0,0,0,0,0,0,0,0,0,0,0,0
DAMAN & DIU,2009,Educational Standard - Post-Graduate,0,0,0,0,0,0,0,0,0,0,0,0,0,0,0
DAMAN & DIU,2009,Educational Standard - Holding technical degree/diploma etc,0,0,0,0,0,0,0,0,0,0,0,0,0,0,0
DAMAN & DIU,2010,Educational Standard,13,1,14,16,0,16,0,0,0,0,0,0,29,1,30
DAMAN & DIU,2010,Educational Standard - Illiterate,1,1,2,0,0,0,0,0,0,0,0,0,1,1,2
DAMAN & DIU,2010,Educational Standard - Below Class X,12,0,12,16,0,16,0,0,0,0,0,0,28,0,28
DAMAN & DIU,2010,Educational Standard - Class X and above but below graduate,0,0,0,0,0,0,0,0,0,0,0,0,0,0,0
DAMAN & DIU,2010,Educational Standard - Graduate,0,0,0,0,0,0,0,0,0,0,0,0,0,0,0
DAMAN & DIU,2010,Educational Standard - Post-Graduate,0,0,0,0,0,0,0,0,0,0,0,0,0,0,0
DAMAN & DIU,2010,Educational Standard - Holding technical degree/diploma etc,0,0,0,0,0,0,0,0,0,0,0,0,0,0,0
DAMAN & DIU,2011,Educational Standard,11,1,12,17,0,17,0,0,0,0,0,0,28,1,29
DAMAN & DIU,2011,Educational Standard - Illiterate,1,1,2,0,0,0,0,0,0,0,0,0,1,1,2
DAMAN & DIU,2011,Educational Standard - Below Class X,10,0,10,17,0,17,0,0,0,0,0,0,27,0,27
DAMAN & DIU,2011,Educational Standard - Class X and above but below graduate,0,0,0,0,0,0,0,0,0,0,0,0,0,0,0
DAMAN & DIU,2011,Educational Standard - Graduate,0,0,0,0,0,0,0,0,0,0,0,0,0,0,0
DAMAN & DIU,2011,Educational Standard - Post-Graduate,0,0,0,0,0,0,0,0,0,0,0,0,0,0,0
DAMAN & DIU,2011,Educational Standard - Holding technical degree/diploma etc,0,0,0,0,0,0,0,0,0,0,0,0,0,0,0
DAMAN & DIU,2012,Educational Standard,13,1,14,10,1,11,0,0,0,0,0,0,23,2,25
DAMAN & DIU,2012,Educational Standard - Illiterate,2,1,3,6,1,7,0,0,0,0,0,0,8,2,10
DAMAN & DIU,2012,Educational Standard - Below Class X,11,0,11,4,0,4,0,0,0,0,0,0,15,0,15
DAMAN & DIU,2012,Educational Standard - Class X and above but below graduate,0,0,0,0,0,0,0,0,0,0,0,0,0,0,0
DAMAN & DIU,2012,Educational Standard - Graduate,0,0,0,0,0,0,0,0,0,0,0,0,0,0,0
DAMAN & DIU,2012,Educational Standard - Post-Graduate,0,0,0,0,0,0,0,0,0,0,0,0,0,0,0
DAMAN & DIU,2012,Educational Standard - Holding technical degree/diploma etc,0,0,0,0,0,0,0,0,0,0,0,0,0,0,0
DELHI,2001,Educational Standard,2104,117,2221,8366,386,8752,49,1,50,0,0,0,10519,504,11023
DELHI,2001,Educational Standard - Illiterate,1063,83,1146,3420,256,3676,12,1,13,0,0,0,4495,340,4835
DELHI,2001,Educational Standard - Below Class X,554,22,576,3254,49,3303,2,0,2,0,0,0,3810,71,3881
DELHI,2001,Educational Standard - Class X and above but below graduate,438,10,448,1382,46,1428,21,0,21,0,0,0,1841,56,1897
DELHI,2001,Educational Standard - Graduate,44,1,45,259,21,280,14,0,14,0,0,0,317,22,339
DELHI,2001,Educational Standard - Post-Graduate,2,1,3,23,13,36,0,0,0,0,0,0,25,14,39
DELHI,2001,Educational Standard - Holding technical degree/diploma etc,3,0,3,28,1,29,0,0,0,0,0,0,31,1,32
DELHI,2002,Educational Standard,2218,115,2333,9275,381,9656,51,1,52,0,0,0,11544,497,12041
DELHI,2002,Educational Standard - Illiterate,1184,91,1275,3400,229,3629,10,1,11,0,0,0,4594,321,4915
DELHI,2002,Educational Standard - Below Class X,599,14,613,3771,59,3830,19,0,19,0,0,0,4389,73,4462
DELHI,2002,Educational Standard - Class X and above but below graduate,395,6,401,1666,54,1720,20,0,20,0,0,0,2081,60,2141
DELHI,2002,Educational Standard - Graduate,36,2,38,387,26,413,2,0,2,0,0,0,425,28,453
DELHI,2002,Educational Standard - Post-Graduate,2,2,4,41,10,51,0,0,0,0,0,0,43,12,55
DELHI,2002,Educational Standard - Holding technical degree/diploma etc,2,0,2,10,3,13,0,0,0,0,0,0,12,3,15
DELHI,2003,Educational Standard,2152,114,2266,9431,435,9866,39,1,40,0,0,0,11622,550,12172
DELHI,2003,Educational Standard - Illiterate,1038,75,1113,3529,321,3850,7,0,7,0,0,0,4574,396,4970
DELHI,2003,Educational Standard - Below Class X,669,18,687,3986,43,4029,13,0,13,0,0,0,4668,61,4729
DELHI,2003,Educational Standard - Class X and above but below graduate,379,19,398,1498,49,1547,11,1,12,0,0,0,1888,69,1957
DELHI,2003,Educational Standard - Graduate,57,2,59,364,11,375,8,0,8,0,0,0,429,13,442
DELHI,2003,Educational Standard - Post-Graduate,5,0,5,39,9,48,0,0,0,0,0,0,44,9,53
DELHI,2003,Educational Standard - Holding technical degree/diploma etc,4,0,4,15,2,17,0,0,0,0,0,0,19,2,21
DELHI,2004,Educational Standard,2376,132,2508,9688,399,10087,15,0,15,0,0,0,12079,531,12610
DELHI,2004,Educational Standard - Illiterate,1013,98,1111,2428,293,2721,2,0,2,0,0,0,3443,391,3834
DELHI,2004,Educational Standard - Below Class X,734,25,759,4646,59,4705,4,0,4,0,0,0,5384,84,5468
DELHI,2004,Educational Standard - Class X and above but below graduate,500,7,507,2312,29,2341,6,0,6,0,0,0,2818,36,2854
DELHI,2004,Educational Standard - Graduate,113,2,115,275,6,281,3,0,3,0,0,0,391,8,399
DELHI,2004,Educational Standard - Post-Graduate,11,0,11,14,7,21,0,0,0,0,0,0,25,7,32
DELHI,2004,Educational Standard - Holding technical degree/diploma etc,5,0,5,13,5,18,0,0,0,0,0,0,18,5,23
DELHI,2005,Educational Standard,2393,117,2510,9421,370,9791,16,0,16,0,0,0,11830,487,12317
DELHI,2005,Educational Standard - Illiterate,913,76,989,3440,227,3667,3,0,3,0,0,0,4356,303,4659
DELHI,2005,Educational Standard - Below Class X,698,25,723,3754,83,3837,4,0,4,0,0,0,4456,108,4564
DELHI,2005,Educational Standard - Class X and above but below graduate,593,0,593,1473,0,1473,4,0,4,0,0,0,2070,0,2070
DELHI,2005,Educational Standard - Graduate,128,12,140,613,41,654,5,0,5,0,0,0,746,53,799
DELHI,2005,Educational Standard - Post-Graduate,50,4,54,109,13,122,0,0,0,0,0,0,159,17,176
DELHI,2005,Educational Standard - Holding technical degree/diploma etc,11,0,11,32,6,38,0,0,0,0,0,0,43,6,49
DELHI,2006,Educational Standard,2370,79,2449,10551,383,10934,16,1,17,0,0,0,12937,463,13400
DELHI,2006,Educational Standard - Illiterate,806,31,837,3916,139,4055,2,0,2,0,0,0,4724,170,4894
DELHI,2006,Educational Standard - Below Class X,1023,13,1036,4516,115,4631,3,0,3,0,0,0,5542,128,5670
DELHI,2006,Educational Standard - Class X and above but below graduate,391,22,413,1559,67,1626,9,0,9,0,0,0,1959,89,2048
DELHI,2006,Educational Standard - Graduate,121,11,132,499,51,550,2,1,3,0,0,0,622,63,685
DELHI,2006,Educational Standard - Post-Graduate,22,2,24,43,11,54,0,0,0,0,0,0,65,13,78
DELHI,2006,Educational Standard - Holding technical degree/diploma etc,7,0,7,18,0,18,0,0,0,0,0,0,25,0,25
DELHI,2007,Educational Standard,2205,63,2268,8892,422,9314,23,0,23,0,0,0,11120,485,11605
DELHI,2007,Educational Standard - Illiterate,884,34,918,2665,219,2884,3,0,3,0,0,0,3552,253,3805
DELHI,2007,Educational Standard - Below Class X,878,12,890,3929,63,3992,9,0,9,0,0,0,4816,75,4891
DELHI,2007,Educational Standard - Class X and above but below graduate,291,13,304,1781,101,1882,9,0,9,0,0,0,2081,114,2195
DELHI,2007,Educational Standard - Graduate,110,3,113,419,26,445,2,0,2,0,0,0,531,29,560
DELHI,2007,Educational Standard - Post-Graduate,31,1,32,71,13,84,0,0,0,0,0,0,102,14,116
DELHI,2007,Educational Standard - Holding technical degree/diploma etc,11,0,11,27,0,27,0,0,0,0,0,0,38,0,38
DELHI,2008,Educational Standard,1922,56,1978,9138,414,9552,19,0,19,4,0,4,11083,470,11553
DELHI,2008,Educational Standard - Illiterate,741,40,781,3300,240,3540,4,0,4,0,0,0,4045,280,4325
DELHI,2008,Educational Standard - Below Class X,612,6,618,3786,71,3857,7,0,7,2,0,2,4407,77,4484
DELHI,2008,Educational Standard - Class X and above but below graduate,441,6,447,1424,65,1489,5,0,5,2,0,2,1872,71,1943
DELHI,2008,Educational Standard - Graduate,101,2,103,388,27,415,3,0,3,0,0,0,492,29,521
DELHI,2008,Educational Standard - Post-Graduate,12,2,14,148,11,159,0,0,0,0,0,0,160,13,173
DELHI,2008,Educational Standard - Holding technical degree/diploma etc,15,0,15,92,0,92,0,0,0,0,0,0,107,0,107
DELHI,2009,Educational Standard,2212,83,2295,8567,364,8931,15,0,15,5,0,5,10799,447,11246
DELHI,2009,Educational Standard - Illiterate,799,51,850,2865,225,3090,3,0,3,0,0,0,3667,276,3943
DELHI,2009,Educational Standard - Below Class X,740,14,754,3437,48,3485,6,0,6,3,0,3,4186,62,4248
DELHI,2009,Educational Standard - Class X and above but below graduate,503,11,514,1663,57,1720,6,0,6,2,0,2,2174,68,2242
DELHI,2009,Educational Standard - Graduate,125,4,129,449,25,474,0,0,0,0,0,0,574,29,603
DELHI,2009,Educational Standard - Post-Graduate,27,2,29,90,8,98,0,0,0,0,0,0,117,10,127
DELHI,2009,Educational Standard - Holding technical degree/diploma etc,18,1,19,63,1,64,0,0,0,0,0,0,81,2,83
DELHI,2010,Educational Standard,2647,104,2751,7686,401,8087,13,0,13,5,0,5,10351,505,10856
DELHI,2010,Educational Standard - Illiterate,910,64,974,2368,214,2582,3,0,3,1,0,1,3282,278,3560
DELHI,2010,Educational Standard - Below Class X,786,21,807,2704,72,2776,5,0,5,1,0,1,3496,93,3589
DELHI,2010,Educational Standard - Class X and above but below graduate,682,13,695,2021,68,2089,5,0,5,0,0,0,2708,81,2789
DELHI,2010,Educational Standard - Graduate,164,4,168,441,39,480,0,0,0,1,0,1,606,43,649
DELHI,2010,Educational Standard - Post-Graduate,20,2,22,102,7,109,0,0,0,1,0,1,123,9,132
DELHI,2010,Educational Standard - Holding technical degree/diploma etc,85,0,85,50,1,51,0,0,0,1,0,1,136,1,137
DELHI,2011,Educational Standard,3091,116,3207,8501,410,8911,6,0,6,0,0,0,11598,526,12124
DELHI,2011,Educational Standard - Illiterate,850,53,903,2252,196,2448,0,0,0,0,0,0,3102,249,3351
DELHI,2011,Educational Standard - Below Class X,1367,39,1406,3355,119,3474,4,0,4,0,0,0,4726,158,4884
DELHI,2011,Educational Standard - Class X and above but below graduate,685,20,705,2271,53,2324,2,0,2,0,0,0,2958,73,3031
DELHI,2011,Educational Standard - Graduate,145,3,148,448,33,481,0,0,0,0,0,0,593,36,629
DELHI,2011,Educational Standard - Post-Graduate,26,1,27,103,6,109,0,0,0,0,0,0,129,7,136
DELHI,2011,Educational Standard - Holding technical degree/diploma etc,18,0,18,72,3,75,0,0,0,0,0,0,90,3,93
DELHI,2012,Educational Standard,3094,125,3219,8472,415,8887,5,0,5,2,0,2,11573,540,12113
DELHI,2012,Educational Standard - Illiterate,418,15,433,1664,139,1803,0,0,0,0,0,0,2082,154,2236
DELHI,2012,Educational Standard - Below Class X,1545,79,1624,4012,145,4157,1,0,1,1,0,1,5559,224,5783
DELHI,2012,Educational Standard - Class X and above but below graduate,922,22,944,2159,87,2246,2,0,2,1,0,1,3084,109,3193
DELHI,2012,Educational Standard - Graduate,149,8,157,478,32,510,2,0,2,0,0,0,629,40,669
DELHI,2012,Educational Standard - Post-Graduate,23,1,24,83,9,92,0,0,0,0,0,0,106,10,116
DELHI,2012,Educational Standard - Holding technical degree/diploma etc,37,0,37,76,3,79,0,0,0,0,0,0,113,3,116
LAKSHADWEEP,2001,Educational Standard,0,0,0,1,0,1,0,0,0,0,0,0,1,0,1
LAKSHADWEEP,2001,Educational Standard - Illiterate,0,0,0,0,0,0,0,0,0,0,0,0,0,0,0
LAKSHADWEEP,2001,Educational Standard - Below Class X,0,0,0,0,0,0,0,0,0,0,0,0,0,0,0
LAKSHADWEEP,2001,Educational Standard - Class X and above but below graduate,0,0,0,0,0,0,0,0,0,0,0,0,0,0,0
LAKSHADWEEP,2001,Educational Standard - Graduate,0,0,0,1,0,1,0,0,0,0,0,0,1,0,1
LAKSHADWEEP,2001,Educational Standard - Post-Graduate,0,0,0,0,0,0,0,0,0,0,0,0,0,0,0
LAKSHADWEEP,2001,Educational Standard - Holding technical degree/diploma etc,0,0,0,0,0,0,0,0,0,0,0,0,0,0,0
LAKSHADWEEP,2002,Educational Standard,2,0,2,14,0,14,0,0,0,0,0,0,16,0,16
LAKSHADWEEP,2002,Educational Standard - Illiterate,0,0,0,0,0,0,0,0,0,0,0,0,0,0,0
LAKSHADWEEP,2002,Educational Standard - Below Class X,2,0,2,13,0,13,0,0,0,0,0,0,15,0,15
LAKSHADWEEP,2002,Educational Standard - Class X and above but below graduate,0,0,0,0,0,0,0,0,0,0,0,0,0,0,0
LAKSHADWEEP,2002,Educational Standard - Graduate,0,0,0,1,0,1,0,0,0,0,0,0,1,0,1
LAKSHADWEEP,2002,Educational Standard - Post-Graduate,0,0,0,0,0,0,0,0,0,0,0,0,0,0,0
LAKSHADWEEP,2002,Educational Standard - Holding technical degree/diploma etc,0,0,0,0,0,0,0,0,0,0,0,0,0,0,0
LAKSHADWEEP,2003,Educational Standard,0,0,0,4,0,4,0,0,0,0,0,0,4,0,4
LAKSHADWEEP,2003,Educational Standard - Illiterate,0,0,0,0,0,0,0,0,0,0,0,0,0,0,0
LAKSHADWEEP,2003,Educational Standard - Below Class X,0,0,0,1,0,1,0,0,0,0,0,0,1,0,1
LAKSHADWEEP,2003,Educational Standard - Class X and above but below graduate,0,0,0,3,0,3,0,0,0,0,0,0,3,0,3
LAKSHADWEEP,2003,Educational Standard - Graduate,0,0,0,0,0,0,0,0,0,0,0,0,0,0,0
LAKSHADWEEP,2003,Educational Standard - Post-Graduate,0,0,0,0,0,0,0,0,0,0,0,0,0,0,0
LAKSHADWEEP,2003,Educational Standard - Holding technical degree/diploma etc,0,0,0,0,0,0,0,0,0,0,0,0,0,0,0
LAKSHADWEEP,2004,Educational Standard,0,0,0,0,0,0,0,0,0,0,0,0,0,0,0
LAKSHADWEEP,2004,Educational Standard - Illiterate,0,0,0,0,0,0,0,0,0,0,0,0,0,0,0
LAKSHADWEEP,2004,Educational Standard - Below Class X,0,0,0,0,0,0,0,0,0,0,0,0,0,0,0
LAKSHADWEEP,2004,Educational Standard - Class X and above but below graduate,0,0,0,0,0,0,0,0,0,0,0,0,0,0,0
LAKSHADWEEP,2004,Educational Standard - Graduate,0,0,0,0,0,0,0,0,0,0,0,0,0,0,0
LAKSHADWEEP,2004,Educational Standard - Post-Graduate,0,0,0,0,0,0,0,0,0,0,0,0,0,0,0
LAKSHADWEEP,2004,Educational Standard - Holding technical degree/diploma etc,0,0,0,0,0,0,0,0,0,0,0,0,0,0,0
LAKSHADWEEP,2005,Educational Standard,0,0,0,6,0,6,0,0,0,0,0,0,6,0,6
LAKSHADWEEP,2005,Educational Standard - Illiterate,0,0,0,2,0,2,0,0,0,0,0,0,2,0,2
LAKSHADWEEP,2005,Educational Standard - Below Class X,0,0,0,3,0,3,0,0,0,0,0,0,3,0,3
LAKSHADWEEP,2005,Educational Standard - Class X and above but below graduate,0,0,0,1,0,1,0,0,0,0,0,0,1,0,1
LAKSHADWEEP,2005,Educational Standard - Graduate,0,0,0,0,0,0,0,0,0,0,0,0,0,0,0
LAKSHADWEEP,2005,Educational Standard - Post-Graduate,0,0,0,0,0,0,0,0,0,0,0,0,0,0,0
LAKSHADWEEP,2005,Educational Standard - Holding technical degree/diploma etc,0,0,0,0,0,0,0,0,0,0,0,0,0,0,0
LAKSHADWEEP,2006,Educational Standard,0,0,0,0,0,0,0,0,0,0,0,0,0,0,0
LAKSHADWEEP,2006,Educational Standard - Illiterate,0,0,0,0,0,0,0,0,0,0,0,0,0,0,0
LAKSHADWEEP,2006,Educational Standard - Below Class X,0,0,0,0,0,0,0,0,0,0,0,0,0,0,0
LAKSHADWEEP,2006,Educational Standard - Class X and above but below graduate,0,0,0,0,0,0,0,0,0,0,0,0,0,0,0
LAKSHADWEEP,2006,Educational Standard - Graduate,0,0,0,0,0,0,0,0,0,0,0,0,0,0,0
LAKSHADWEEP,2006,Educational Standard - Post-Graduate,0,0,0,0,0,0,0,0,0,0,0,0,0,0,0
LAKSHADWEEP,2006,Educational Standard - Holding technical degree/diploma etc,0,0,0,0,0,0,0,0,0,0,0,0,0,0,0
LAKSHADWEEP,2007,Educational Standard,3,0,3,11,0,11,0,0,0,8,0,8,22,0,22
LAKSHADWEEP,2007,Educational Standard - Illiterate,0,0,0,0,0,0,0,0,0,0,0,0,0,0,0
LAKSHADWEEP,2007,Educational Standard - Below Class X,3,0,3,11,0,11,0,0,0,2,0,2,16,0,16
LAKSHADWEEP,2007,Educational Standard - Class X and above but below graduate,0,0,0,0,0,0,0,0,0,6,0,6,6,0,6
LAKSHADWEEP,2007,Educational Standard - Graduate,0,0,0,0,0,0,0,0,0,0,0,0,0,0,0
LAKSHADWEEP,2007,Educational Standard - Post-Graduate,0,0,0,0,0,0,0,0,0,0,0,0,0,0,0
LAKSHADWEEP,2007,Educational Standard - Holding technical degree/diploma etc,0,0,0,0,0,0,0,0,0,0,0,0,0,0,0
LAKSHADWEEP,2008,Educational Standard,0,0,0,19,0,19,0,0,0,0,0,0,19,0,19
LAKSHADWEEP,2008,Educational Standard - Illiterate,0,0,0,0,0,0,0,0,0,0,0,0,0,0,0
LAKSHADWEEP,2008,Educational Standard - Below Class X,0,0,0,17,0,17,0,0,0,0,0,0,17,0,17
LAKSHADWEEP,2008,Educational Standard - Class X and above but below graduate,0,0,0,2,0,2,0,0,0,0,0,0,2,0,2
LAKSHADWEEP,2008,Educational Standard - Graduate,0,0,0,0,0,0,0,0,0,0,0,0,0,0,0
LAKSHADWEEP,2008,Educational Standard - Post-Graduate,0,0,0,0,0,0,0,0,0,0,0,0,0,0,0
LAKSHADWEEP,2008,Educational Standard - Holding technical degree/diploma etc,0,0,0,0,0,0,0,0,0,0,0,0,0,0,0
LAKSHADWEEP,2009,Educational Standard,1,0,1,43,0,43,0,0,0,0,0,0,44,0,44
LAKSHADWEEP,2009,Educational Standard - Illiterate,0,0,0,0,0,0,0,0,0,0,0,0,0,0,0
LAKSHADWEEP,2009,Educational Standard - Below Class X,1,0,1,36,0,36,0,0,0,0,0,0,37,0,37
LAKSHADWEEP,2009,Educational Standard - Class X and above but below graduate,0,0,0,6,0,6,0,0,0,0,0,0,6,0,6
LAKSHADWEEP,2009,Educational Standard - Graduate,0,0,0,1,0,1,0,0,0,0,0,0,1,0,1
LAKSHADWEEP,2009,Educational Standard - Post-Graduate,0,0,0,0,0,0,0,0,0,0,0,0,0,0,0
LAKSHADWEEP,2009,Educational Standard - Holding technical degree/diploma etc,0,0,0,0,0,0,0,0,0,0,0,0,0,0,0
LAKSHADWEEP,2010,Educational Standard,0,0,0,27,0,27,0,0,0,0,0,0,27,0,27
LAKSHADWEEP,2010,Educational Standard - Illiterate,0,0,0,14,0,14,0,0,0,0,0,0,14,0,14
LAKSHADWEEP,2010,Educational Standard - Below Class X,0,0,0,9,0,9,0,0,0,0,0,0,9,0,9
LAKSHADWEEP,2010,Educational Standard - Class X and above but below graduate,0,0,0,4,0,4,0,0,0,0,0,0,4,0,4
LAKSHADWEEP,2010,Educational Standard - Graduate,0,0,0,0,0,0,0,0,0,0,0,0,0,0,0
LAKSHADWEEP,2010,Educational Standard - Post-Graduate,0,0,0,0,0,0,0,0,0,0,0,0,0,0,0
LAKSHADWEEP,2010,Educational Standard - Holding technical degree/diploma etc,0,0,0,0,0,0,0,0,0,0,0,0,0,0,0
LAKSHADWEEP,2011,Educational Standard,0,0,0,29,1,30,50,0,50,0,0,0,79,1,80
LAKSHADWEEP,2011,Educational Standard - Illiterate,0,0,0,14,0,14,0,0,0,0,0,0,14,0,14
LAKSHADWEEP,2011,Educational Standard - Below Class X,0,0,0,13,1,14,0,0,0,0,0,0,13,1,14
LAKSHADWEEP,2011,Educational Standard - Class X and above but below graduate,0,0,0,2,0,2,50,0,50,0,0,0,52,0,52
LAKSHADWEEP,2011,Educational Standard - Graduate,0,0,0,0,0,0,0,0,0,0,0,0,0,0,0
LAKSHADWEEP,2011,Educational Standard - Post-Graduate,0,0,0,0,0,0,0,0,0,0,0,0,0,0,0
LAKSHADWEEP,2011,Educational Standard - Holding technical degree/diploma etc,0,0,0,0,0,0,0,0,0,0,0,0,0,0,0
LAKSHADWEEP,2012,Educational Standard,0,0,0,0,0,0,0,0,0,0,0,0,0,0,0
LAKSHADWEEP,2012,Educational Standard - Illiterate,0,0,0,0,0,0,0,0,0,0,0,0,0,0,0
LAKSHADWEEP,2012,Educational Standard - Below Class X,0,0,0,0,0,0,0,0,0,0,0,0,0,0,0
LAKSHADWEEP,2012,Educational Standard - Class X and above but below graduate,0,0,0,0,0,0,0,0,0,0,0,0,0,0,0
LAKSHADWEEP,2012,Educational Standard - Graduate,0,0,0,0,0,0,0,0,0,0,0,0,0,0,0
LAKSHADWEEP,2012,Educational Standard - Post-Graduate,0,0,0,0,0,0,0,0,0,0,0,0,0,0,0
LAKSHADWEEP,2012,Educational Standard - Holding technical degree/diploma etc,0,0,0,0,0,0,0,0,0,0,0,0,0,0,0
PONDICHERRY,2001,Educational Standard,107,1,108,149,5,154,0,0,0,0,0,0,256,6,262
PONDICHERRY,2001,Educational Standard - Illiterate,22,1,23,36,2,38,0,0,0,0,0,0,58,3,61
PONDICHERRY,2001,Educational Standard - Below Class X,48,0,48,62,3,65,0,0,0,0,0,0,110,3,113
PONDICHERRY,2001,Educational Standard - Class X and above but below graduate,36,0,36,51,0,51,0,0,0,0,0,0,87,0,87
PONDICHERRY,2001,Educational Standard - Graduate,0,0,0,0,0,0,0,0,0,0,0,0,0,0,0
PONDICHERRY,2001,Educational Standard - Post-Graduate,0,0,0,0,0,0,0,0,0,0,0,0,0,0,0
PONDICHERRY,2001,Educational Standard - Holding technical degree/diploma etc,1,0,1,0,0,0,0,0,0,0,0,0,1,0,1
PONDICHERRY,2002,Educational Standard,133,1,134,100,12,112,0,0,0,0,0,0,233,13,246
PONDICHERRY,2002,Educational Standard - Illiterate,28,1,29,19,7,26,0,0,0,0,0,0,47,8,55
PONDICHERRY,2002,Educational Standard - Below Class X,62,0,62,68,5,73,0,0,0,0,0,0,130,5,135
PONDICHERRY,2002,Educational Standard - Class X and above but below graduate,37,0,37,8,0,8,0,0,0,0,0,0,45,0,45
PONDICHERRY,2002,Educational Standard - Graduate,2,0,2,5,0,5,0,0,0,0,0,0,7,0,7
PONDICHERRY,2002,Educational Standard - Post-Graduate,0,0,0,0,0,0,0,0,0,0,0,0,0,0,0
PONDICHERRY,2002,Educational Standard - Holding technical degree/diploma etc,4,0,4,0,0,0,0,0,0,0,0,0,4,0,4
PONDICHERRY,2003,Educational Standard,137,2,139,135,4,139,0,0,0,0,0,0,272,6,278
PONDICHERRY,2003,Educational Standard - Illiterate,30,2,32,48,4,52,0,0,0,0,0,0,78,6,84
PONDICHERRY,2003,Educational Standard - Below Class X,56,0,56,73,0,73,0,0,0,0,0,0,129,0,129
PONDICHERRY,2003,Educational Standard - Class X and above but below graduate,46,0,46,12,0,12,0,0,0,0,0,0,58,0,58
PONDICHERRY,2003,Educational Standard - Graduate,3,0,3,2,0,2,0,0,0,0,0,0,5,0,5
PONDICHERRY,2003,Educational Standard - Post-Graduate,0,0,0,0,0,0,0,0,0,0,0,0,0,0,0
PONDICHERRY,2003,Educational Standard - Holding technical degree/diploma etc,2,0,2,0,0,0,0,0,0,0,0,0,2,0,2
PONDICHERRY,2004,Educational Standard,107,2,109,191,1,192,0,0,0,0,0,0,298,3,301
PONDICHERRY,2004,Educational Standard - Illiterate,38,1,39,42,1,43,0,0,0,0,0,0,80,2,82
PONDICHERRY,2004,Educational Standard - Below Class X,46,1,47,87,0,87,0,0,0,0,0,0,133,1,134
PONDICHERRY,2004,Educational Standard - Class X and above but below graduate,20,0,20,52,0,52,0,0,0,0,0,0,72,0,72
PONDICHERRY,2004,Educational Standard - Graduate,2,0,2,8,0,8,0,0,0,0,0,0,10,0,10
PONDICHERRY,2004,Educational Standard - Post-Graduate,1,0,1,2,0,2,0,0,0,0,0,0,3,0,3
PONDICHERRY,2004,Educational Standard - Holding technical degree/diploma etc,0,0,0,0,0,0,0,0,0,0,0,0,0,0,0
PONDICHERRY,2005,Educational Standard,114,5,119,168,1,169,0,0,0,0,0,0,282,6,288
PONDICHERRY,2005,Educational Standard - Illiterate,34,2,36,39,1,40,0,0,0,0,0,0,73,3,76
PONDICHERRY,2005,Educational Standard - Below Class X,52,3,55,75,0,75,0,0,0,0,0,0,127,3,130
PONDICHERRY,2005,Educational Standard - Class X and above but below graduate,26,0,26,43,0,43,0,0,0,0,0,0,69,0,69
PONDICHERRY,2005,Educational Standard - Graduate,2,0,2,11,0,11,0,0,0,0,0,0,13,0,13
PONDICHERRY,2005,Educational Standard - Post-Graduate,0,0,0,0,0,0,0,0,0,0,0,0,0,0,0
PONDICHERRY,2005,Educational Standard - Holding technical degree/diploma etc,0,0,0,0,0,0,0,0,0,0,0,0,0,0,0
PONDICHERRY,2006,Educational Standard,106,3,109,202,1,203,0,0,0,0,0,0,308,4,312
PONDICHERRY,2006,Educational Standard - Illiterate,31,2,33,47,1,48,0,0,0,0,0,0,78,3,81
PONDICHERRY,2006,Educational Standard - Below Class X,48,1,49,108,0,108,0,0,0,0,0,0,156,1,157
PONDICHERRY,2006,Educational Standard - Class X and above but below graduate,24,0,24,32,0,32,0,0,0,0,0,0,56,0,56
PONDICHERRY,2006,Educational Standard - Graduate,3,0,3,11,0,11,0,0,0,0,0,0,14,0,14
PONDICHERRY,2006,Educational Standard - Post-Graduate,0,0,0,4,0,4,0,0,0,0,0,0,4,0,4
PONDICHERRY,2006,Educational Standard - Holding technical degree/diploma etc,0,0,0,0,0,0,0,0,0,0,0,0,0,0,0
PONDICHERRY,2007,Educational Standard,110,2,112,232,2,234,0,0,0,0,0,0,342,4,346
PONDICHERRY,2007,Educational Standard - Illiterate,29,1,30,52,1,53,0,0,0,0,0,0,81,2,83
PONDICHERRY,2007,Educational Standard - Below Class X,52,1,53,122,1,123,0,0,0,0,0,0,174,2,176
PONDICHERRY,2007,Educational Standard - Class X and above but below graduate,26,0,26,44,0,44,0,0,0,0,0,0,70,0,70
PONDICHERRY,2007,Educational Standard - Graduate,3,0,3,13,0,13,0,0,0,0,0,0,16,0,16
PONDICHERRY,2007,Educational Standard - Post-Graduate,0,0,0,1,0,1,0,0,0,0,0,0,1,0,1
PONDICHERRY,2007,Educational Standard - Holding technical degree/diploma etc,0,0,0,0,0,0,0,0,0,0,0,0,0,0,0
PONDICHERRY,2008,Educational Standard,96,1,97,198,5,203,0,0,0,0,0,0,294,6,300
PONDICHERRY,2008,Educational Standard - Illiterate,24,1,25,49,3,52,0,0,0,0,0,0,73,4,77
PONDICHERRY,2008,Educational Standard - Below Class X,43,0,43,118,2,120,0,0,0,0,0,0,161,2,163
PONDICHERRY,2008,Educational Standard - Class X and above but below graduate,26,0,26,24,0,24,0,0,0,0,0,0,50,0,50
PONDICHERRY,2008,Educational Standard - Graduate,3,0,3,6,0,6,0,0,0,0,0,0,9,0,9
PONDICHERRY,2008,Educational Standard - Post-Graduate,0,0,0,1,0,1,0,0,0,0,0,0,1,0,1
PONDICHERRY,2008,Educational Standard - Holding technical degree/diploma etc,0,0,0,0,0,0,0,0,0,0,0,0,0,0,0
PONDICHERRY,2009,Educational Standard,117,2,119,149,1,150,0,0,0,0,0,0,266,3,269
PONDICHERRY,2009,Educational Standard - Illiterate,22,2,24,27,1,28,0,0,0,0,0,0,49,3,52
PONDICHERRY,2009,Educational Standard - Below Class X,88,0,88,95,0,95,0,0,0,0,0,0,183,0,183
PONDICHERRY,2009,Educational Standard - Class X and above but below graduate,6,0,6,24,0,24,0,0,0,0,0,0,30,0,30
PONDICHERRY,2009,Educational Standard - Graduate,1,0,1,1,0,1,0,0,0,0,0,0,2,0,2
PONDICHERRY,2009,Educational Standard - Post-Graduate,0,0,0,0,0,0,0,0,0,0,0,0,0,0,0
PONDICHERRY,2009,Educational Standard - Holding technical degree/diploma etc,0,0,0,2,0,2,0,0,0,0,0,0,2,0,2
PONDICHERRY,2010,Educational Standard,128,2,130,124,4,128,3,0,3,0,0,0,255,6,261
PONDICHERRY,2010,Educational Standard - Illiterate,46,1,47,26,4,30,0,0,0,0,0,0,72,5,77
PONDICHERRY,2010,Educational Standard - Below Class X,68,1,69,75,0,75,3,0,3,0,0,0,146,1,147
PONDICHERRY,2010,Educational Standard - Class X and above but below graduate,12,0,12,20,0,20,0,0,0,0,0,0,32,0,32
PONDICHERRY,2010,Educational Standard - Graduate,1,0,1,0,0,0,0,0,0,0,0,0,1,0,1
PONDICHERRY,2010,Educational Standard - Post-Graduate,1,0,1,0,0,0,0,0,0,0,0,0,1,0,1
PONDICHERRY,2010,Educational Standard - Holding technical degree/diploma etc,0,0,0,3,0,3,0,0,0,0,0,0,3,0,3
PONDICHERRY,2011,Educational Standard,127,3,130,110,2,112,0,0,0,0,0,0,237,5,242
PONDICHERRY,2011,Educational Standard - Illiterate,42,1,43,30,0,30,0,0,0,0,0,0,72,1,73
PONDICHERRY,2011,Educational Standard - Below Class X,50,2,52,29,2,31,0,0,0,0,0,0,79,4,83
PONDICHERRY,2011,Educational Standard - Class X and above but below graduate,24,0,24,44,0,44,0,0,0,0,0,0,68,0,68
PONDICHERRY,2011,Educational Standard - Graduate,10,0,10,7,0,7,0,0,0,0,0,0,17,0,17
PONDICHERRY,2011,Educational Standard - Post-Graduate,0,0,0,0,0,0,0,0,0,0,0,0,0,0,0
PONDICHERRY,2011,Educational Standard - Holding technical degree/diploma etc,1,0,1,0,0,0,0,0,0,0,0,0,1,0,1
PONDICHERRY,2012,Educational Standard,107,2,109,175,1,176,0,0,0,0,0,0,282,3,285
PONDICHERRY,2012,Educational Standard - Illiterate,42,1,43,44,1,45,0,0,0,0,0,0,86,2,88
PONDICHERRY,2012,Educational Standard - Below Class X,42,1,43,74,0,74,0,0,0,0,0,0,116,1,117
PONDICHERRY,2012,Educational Standard - Class X and above but below graduate,14,0,14,48,0,48,0,0,0,0,0,0,62,0,62
PONDICHERRY,2012,Educational Standard - Graduate,8,0,8,8,0,8,0,0,0,0,0,0,16,0,16
PONDICHERRY,2012,Educational Standard - Post-Graduate,0,0,0,1,0,1,0,0,0,0,0,0,1,0,1
PONDICHERRY,2012,Educational Standard - Holding technical degree/diploma etc,1,0,1,0,0,0,0,0,0,0,0,0,1,0,1
